感じ	かんじ
商品	しょうひん
写真	しゃしん|じゃしん
問題	もんだい
世界	せかい
記事	きじ
問い合わせ	といあわせ
仕事	しごと
使用	しよう
研究	けんきゅう
時代	じだい
事業	じぎょう
言葉	ことば
活動	かつどう
意味	いみ
作品	さくひん
受け	うけ
場所	ばしょ
教育	きょういく
部屋	へや|べや
全国	ぜんこく
向け	むけ
予定	よてい
病院	びょういん
部分	ぶぶん
会員	かいいん
開発	かいはつ
相談	そうだん
相手	あいて
始め	はじめ
委員	いいん
全て	すべて
意見	いけん
旅行	りょこう
気持ち	きもち
悪い	わるい|わりい|わろい
一部	いちぶ
注文	ちゅうもん|ちゅうぶん
家族	かぞく
注意	ちゅうい
理由	りゆう
指定	してい
期待	きたい
発表	はっぴょう
代表	だいひょう
文化	ぶんか
公開	こうかい
流れ	ながれ
登場	とうじょう
使い	つかい|つかわい|づかい
安全	あんぜん
年度	ねんど
作業	さぎょう
安心	あんしん
自身	じしん
取引	とりひき
使う	つかう|つこう
開始	かいし
自由	じゆう
全体	ぜんたい
一度	ひとたび|いちど
勉強	べんきょう
決定	けってい
話題	わだい
時期	じき
期間	きかん
発生	はっせい
放送	ほうそう
全く	まったく
発売	はつばい
行動	こうどう
動画	どうが
工事	こうじ
番号	ばんごう
持つ	もつ
中央	ちゅうおう
練習	れんしゅう
食事	しょくじ
第一	だいいち
全部	ぜんぶ
運動	うんどう
歯科	しか
様子	ようす
道路	どうろ
注目	ちゅうもく
発見	はっけん
今度	こんど
感想	かんそう
家庭	かてい
心配	しんぱい
有名	ゆうめい
都市	とし
学習	がくしゅう
面白い	おもしろい
動物	どうぶつ
住所	じゅうしょ
自動車	じどうしゃ
事実	じじつ
方向	ほうこう
神社	じんじゃ
地区	ちく
予想	よそう
決め	きめ|ぎめ
持ち	もち
画面	がめん
動き	うごき
落ち	おち
用意	ようい
身体	しんたい|からだ
運転	うんてん
幸せ	しあわせ
野球	やきゅう
調べ	しらべ
負け	まけ
銀行	ぎんこう
地球	ちきゅう
美味しい	おいしい
食品	しょくひん
終わり	おわり
発送	はっそう
遊び	あそび|すさび
仕方	しかた
物語	ものがたり
祭り	まつり
飲み	のみ
業者	ぎょうしゃ
感じる	かんじる
鉄道	てつどう
起き	おき
大事	おおごと|だいじ
発言	はつげん
美しい	うつくしい
気軽	きがる
病気	びょうき
全員	ぜんいん
発行	はっこう
交流	こうりゅう
問合せ	といあわせ
業界	ぎょうかい
買い物	かいもの
人物	じんぶつ
同様	どうよう
文章	ぶんしょう
取り	とり|どり
調整	ちょうせい
感動	かんどう
用品	ようひん
反対	はんたい
具体	ぐたい
高速	こうそく
医院	いいん
社員	しゃいん
目指し	めざし
受ける	うける
自転車	じてんしゃ
住まい	すまい|ずまい
勝手	かって|がって
安定	あんてい
送る	おくる
集め	あつめ
息子	むすこ
向上	こうじょう
植物	しょくぶつ
安い	やすい|やしい
予算	よさん
相当	そうとう
次回	じかい
読者	どくしゃ
平和	へいわ
公式	こうしき
路線	ろせん
自動	じどう
丁目	ちょうめ
方面	ほうめん
農業	のうぎょう
事前	じぜん
出発	しゅっぱつ
年代	ねんだい
始まり	はじまり
新着	しんちゃく
出身	しゅっしん
整理	せいり
使える	つかえる
首相	しゅしょう
旅館	りょかん
近所	きんじょ
有り	あり
強化	きょうか
実行	じっこう
他人	たにん|ひと|びと
使い方	つかいかた
空港	くうこう
子育て	こそだて
集中	しゅうちゅう
定期	ていき
生命	せいめい|いのち
配送	はいそう
始まる	はじまる
去年	こぞ|きょねん
主な	おもな
登山	とざん
勝手に	かってに
目指す	めざす
太陽	たいよう
深い	ふかい|ぶかい
守る	まもる|もる
決して	けっして|けして
都合	つごう
始める	はじめる
始めて	はじめて
次第	しだい
県内	けんない
世代	せだい
仕様	しよう
記者	きしゃ
表記	ひょうき
勝ち	かち|がち
定める	さだめる
高級	こうきゅう
運用	うんよう
係る	かかわる|かかる
取り組み	とりくみ
車両	しゃりょう
見事	みごと
回転	かいてん
調子	ちょうし|ぢょうし
返品	へんぴん
内部	ないぶ
進む	すすむ
商店	しょうてん
文庫	ぶんこ
主に	おもに
列車	れっしゃ
代わり	かわり|がわり
化学	かがく|ばけがく
取る	とる|どる
流し	ながし
乗り	のり
駅前	えきまえ
理事	りじ
表面	ひょうめん
向かう	むかう
生物	せいぶつ|なまもの
助け	たすけ|すけ
部門	ぶもん
長期	ちょうき
形式	けいしき
待ち	まち
工業	こうぎょう
寒い	さむい|さぶい|さみい|さびい
出来事	できごと
返事	へんじ
終わる	おわる
落とし	おとし
場面	ばめん
飲食	いんしょく|おんじき
世の中	よのなか
代金	だいきん
早速	さっそく
育て	そだて
本部	ほんぶ
苦手	にがて
主人	しゅじん
方式	ほうしき
勝負	しょうぶ
相場	そうば
温度	おんど
所有	しょゆう
死ぬ	しぬ
思想	しそう
理想	りそう
暑い	あつい|あちい
中身	なかみ
同意	どうい
医学	いがく
実家	じっか
進行	しんこう
投げ	なげ
幸い	さいわい
放題	ほうだい
起こし	おこし
入荷	にゅうか
意外	いがい
行事	ぎょうじ
発電	はつでん
動作	どうさ
漢字	かんじ
速度	そくど
定め	さだめ
家具	かぐ
一定	いちじょう|いってい
実感	じっかん
集合	しゅうごう
調べる	しらべる
化する	かする
開き	あき|ひらき|びらき
出品	しゅっぴん
入院	にゅういん
向こう	むこう
部品	ぶひん
飲む	のむ
医者	いしゃ
作者	さくしゃ
知事	ちじ
打ち	うち|ぶち
両方	りょうほう
真実	しんじつ
仕上げ	しあげ
短い	みじかい
重ね	かさね|がさね
荷物	にもつ
想い	おもい
出荷	しゅっか
部長	ぶちょう
屋根	やね
開く	あく|ひらく
道具	どうぐ
地下鉄	ちかてつ
海岸	うみぎし|かいがん
近代	きんだい
本物	ほんもの
外部	がいぶ
体調	たいちょう
美人	びじん|めいれん
多様	たよう
着物	きもの
向き	むき
両親	りょうしん
役立つ	やくだつ
実に	げに
食べ物	たべもの
気温	きおん
古代	こだい
受け入れ	うけいれ
返し	かえし|がえし
平日	へいじつ
高等	こうとう
買取	かいとり
有する	ゆうする
住む	すむ
具合	ぐあい|ぐわい
重い	おもい
進化	しんか
人事	じんじ|ひとごと
実力	じつりょく
動く	うごく
決勝	けっしょう
進み	すすみ
世間	せけん
役員	やくいん
仕方ない	しかたない
取り上げ	とりあげ
仕組み	しくみ
高度	こうど
深夜	しんや
向い	むい|むかい
待つ	まつ
乗る	のる
首都	しゅと
有る	ある
調理	ちょうり
上部	じょうぶ
気味	きみ|ぎみ
味わい	あじわい
意思	いし
流れる	ながれる
由来	ゆらい
物理	ぶつり
投手	とうしゅ
次元	じげん
身近	みじか
運命	うんめい
発明	はつめい
正式	せいしき
店員	てんいん
向かい	むかい
天使	てんし
起こる	おこる
公表	こうひょう
代理	だいり
表紙	ひょうし|びょうし
体重	たいじゅう
農家	のうか
植え	うえ
登り	のぼり
全身	ぜんしん
会館	かいかん
決める	きめる
乗せ	のせ
軽い	かるい|かりい
死に	しに|じに
悲しい	かなしい
薬局	やっきょく
教員	きょういん
予め	あらかじめ
整形	せいけい
県立	けんりつ
発想	はっそう
小屋	こや|ごや|しょうおく
開業	かいぎょう
南部	なんぶ
開放	かいほう
正面	せいめん|しょうめん
進出	しんしゅつ
流行	りゅうこう|はやり|ばやり
決算	けっさん
守り	まもり|もり
消し	けし
想定	そうてい
動向	どうこう
意図	いと
商業	しょうぎょう
作曲	さっきょく
落ちる	おちる
定番	ていばん
進学	しんがく
風味	ふうみ
真ん中	まんなか
遊ぶ	あそぶ
学者	がくしゃ
悪化	あっか
決まり	きまり
進める	すすめる
真面目	まじめ
流通	りゅうつう|るずう
起動	きどう
主体	しゅたい
生き物	いきもの
美し	うつくし
集会	しゅうかい
短期	たんき
集まり	あつまり
送り	おくり
消化	しょうか
手軽	てがる
交代	こうたい
様式	ようしき
表明	ひょうめい
全面	ぜんめん
目安	めやす
早期	そうき
電波	でんぱ
休業	きゅうぎょう
運行	うんこう
問い合せ	といあわせ
味方	みかた
乗車	じょうしゃ
代行	だいこう
学問	がくもん
小物	こもの
強調	きょうちょう
学部	がくぶ
合意	ごうい
都内	とない
投入	とうにゅう
名物	めいぶつ
自主	じしゅ
暗い	くらい|ぐらい
和食	わしょく
石油	せきゆ
間取り	まどり
勝つ	かつ|まさつ
区間	くかん
区分	くぶん
決意	けつい
集まる	あつまる
気配	けはい|きはい
平気	へいき
根本	こんぼん|こんぽん|ねもと
体育	たいいく
農薬	のうやく
幸福	こうふく
客室	きゃくしつ
取り入れ	とりいれ
回路	かいろ
育てる	そだてる
配合	はいごう
島根	しまね
予感	よかん
実用	じつよう
合流	ごうりゅう
後期	こうき
商売	しょうばい
実習	じっしゅう
この世	このよ
主役	しゅやく
北部	ほくぶ
庭園	ていえん
両手	りょうて|もろて
地面	じめん
仕入れ	しいれれ|しいれ
和風	わふう
全力	ぜんりょく
西洋	せいよう
一面	いちめん
目次	もくじ
住人	じゅうにん
起きる	おきる
行列	ぎょうれつ
局長	きょくちょう
打つ	うつ|ぶつ
角度	かくど
都会	とかい
集落	しゅうらく
手配	てはい
指名	しめい
市区	しく
大根	だいこん|おおね
合宿	がっしゅく
起こす	おこす
名所	めいしょ|などころ
寺院	じいん
強度	きょうど
感心	かんしん
着く	つく
登る	のぼる
手帳	てちょう
流石	さすが
受注	じゅちゅう
発注	はっちゅう
本屋	ほんや
暗号	あんごう
新品	しんぴん
中部	ちゅうぶ
起業	きぎょう
落語	らくご
取れる	とれる
動かす	うごかす
対立	たいりつ
開花	かいか
対決	たいけつ
中島	なかじま
起こり	おこり
落とす	おとす
定食	ていしょく
橋本	はしもと
大宮	おおみや
発足	ほっそく|はっそく
打ち合わせ	うちあわせ
大島	おおしま
神話	しんわ
工具	こうぐ
活発	かっぱつ
反発	はんぱつ
苦しい	くるしい|ぐるしい
大豆	だいず
整体	せいたい
定員	ていいん
丁度	ちょうど
一品	いっぴん
問い	とい
開ける	あける|ひらける
重大	じゅうだい
表す	あらわす|ひょうす
取り出し	とりだし
半島	はんとう
地味	ちみ|じみ
登記	とうき
速い	はやい|ばやい
身長	しんちょう
市区町村	しくちょうそん
役者	やくしゃ
東洋	とうよう
先進	せんしん
全文	ぜんぶん
育ち	そだち
部下	ぶか
県道	けんどう
着用	ちゃくよう
定着	ていちゃく
当局	とうきょく
返答	へんとう
平野	へいや
平安	へいあん
何事	なにごと
決まる	きまる
返す	かえす
負荷	ふか
洋服	ようふく
階級	かいきゅう
水着	みずぎ
仕立て	したて|じたて
部員	ぶいん
開店	かいてん
転送	てんそう
海洋	かいよう
進歩	しんぽ
前向き	まえむき
同期	どうき
発音	はつおん
負ける	まける
真っ赤	まっか
発動	はつどう
仕上がり	しあがり
世話	せわ|ぜわ
院長	いんちょう
下着	したぎ
子宮	しきゅう
飲み物	のみもの
都心	としん
物流	ぶつりゅう
一族	いちぞく
生息	せいそく
上品	じょうぼん|じょうひん
大橋	おおはし
死体	したい
運送	うんそう
一流	いちりゅう
金持ち	かねもち|がねもち
温かい	あたたかい
駅名	えきめい
学院	がくいん
集計	しゅうけい
内定	ないてい
対話	たいわ
流出	りゅうしゅつ
筆者	ひっしゃ
西部	せいぶ
上流	じょうりゅう
部会	ぶかい
行使	こうし
楽曲	がっきょく
体感	たいかん
進路	しんろ
記号	きごう
他社	たしゃ
神田	しんでん
店主	てんしゅ
農園	のうえん
消える	きえる
運び	はこび
身分	みぶん
食感	しょっかん
通路	つうろ|かよいじ
両者	りょうしゃ
急速	きゅうそく
美味い	うまい
受け取り	うけとり
出血	しゅっけつ|でち
下落	げらく
調和	ちょうわ
有力	ゆうりょく
指し	さし|ざし
電化	でんか
緑色	みどりいろ|りょくしょく
調味	ちょうみ
女神	めがみ|じょしん|にょしん
学級	がっきゅう
勝てる	かてる
打ち上げ	うちあげ|ぶちあげ
中世	ちゅうせい
死者	ししゃ
心身	しんしん
指数	しすう
商工	しょうこう
線路	せんろ
会談	かいだん
前期	ぜんき
物事	ものごと
上級	じょうきゅう
先発	せんぱつ
配当	はいとう
直送	ちょくそう
和室	わしつ
家事	かじ
流す	ながす
定休	ていきゅう
万全	ばんぜん
部活	ぶかつ
問う	とう
図面	ずめん
後者	こうしゃ
開通	かいつう
水面	すいめん|みなも|みのも
代引き	だいびき
食物	くいもの|しょくもつ
東部	とうぶ
集める	あつめる
球場	きゅうじょう
農村	のうそん
口調	くちょう
真相	しんそう
美味	びみ|うま
天神	てんしん|てんじん
意向	いこう
館内	かんない
台所	だいどころ
カ所	かしょ
礼金	れいきん
写し	うつし
高温	こうおん
漢方	かんぽう
相対	あいたい|そうたい
屋外	おくがい
屋台	やたい
実物	じつぶつ|みもの
真理	しんり
指す	さす
運ぶ	はこぶ
区画	くかく
平等	びょうどう
転用	てんよう
所持	しょじ
電動	でんどう
服用	ふくよう
屋上	おくじょう
急行	きゅうこう
用事	ようじ
味わう	あじわう
美女	びじょ
同等	どうとう
飲み会	のみかい
登校	とうこう
追う	おう
文部	もんぶ
追記	ついき
宿題	しゅくだい
水平	すいへい
当院	とういん
鉄板	てっぱん
大物	おおもの
持ち主	もちぬし
対談	たいだん
日和	ひより|びより
問屋	といや|とんや|どいや|どんや
使命	しめい
前進	ぜんしん
持ち帰り	もちかえり
役所	やくしょ|やくどころ
去る	さる
着る	きる
重点	じゅうてん
所定	しょてい
原油	げんゆ
放出	ほうしゅつ
助手	じょしゅ
農林	のうりん
飲酒	いんしゅ|おんじゅ
申し出	もうしで
詩人	しじん
薬物	やくぶつ
題名	だいめい
路面	ろめん
真っ白	まっしろ
農地	のうち
電流	でんりゅう
路上	ろじょう
他者	たしゃ
安打	あんだ
悲鳴	ひめい
先物	さきもの
算定	さんてい
定年	ていねん
下部	かぶ
幸運	こううん
中期	ちゅうき
家屋	かおく
両国	りょうこく
葉っぱ	はっぱ
真夏	まなつ
うつ病	うつびょう
主流	しゅりゅう
神宮	じんぐう
化合	かごう
落ち着き	おちつき
主力	しゅりょく
悪口	わるぐち|あっこう|わるくち
商人	しょうにん|あきんど|あきゅうど
配線	はいせん
毎度	まいど
書面	しょめん
大使	たいし
所長	しょちょう
急ぎ	いそぎ
やり取り	やりとり
役場	やくば
有用	ゆうよう
乗客	じょうきゃく
買物	かいもの
配列	はいれつ
返金	へんきん
学期	がっき
人員	じんいん
速やか	すみやか
親族	しんぞく
曲げ	まげ
神楽	かぐら
習い事	ならいごと
命名	めいめい
島田	しまだ
消す	けす
路地	ろじ
配分	はいぶん
ため息	ためいき
茶屋	じゃや|ちゃや
前面	ぜんめん
名曲	めいきょく
陽気	ようき
反日	はんにち
電鉄	でんてつ
次男	じなん
落下	らっか
助ける	たすける|すける
役目	やくめ
言動	げんどう
育つ	そだつ
小島	こじま
水泳	すいえい
列島	れっとう
向ける	むける
新曲	しんきょく
原発	げんぱつ
取り消し	とりけし
放つ	はなつ
体温	たいおん
反する	はんする
化石	かせき
部落	ぶらく
味わえる	あじわえる
出題	しゅつだい
投下	とうか
全集	ぜんしゅう
指先	ゆびさき
洋食	ようしょく
待ち合わせ	まちあわせ
両面	りょうめん
着手	ちゃくしゅ
負う	おう
下流	かりゅう
港区	こうく
助言	じょげん|じょごん
当面	とうめん
多発	たはつ
集い	すだい|つどい
全開	ぜんかい
両立	りょうりつ
前者	ぜんしゃ
炭火	すみび
生育	せいいく
船橋	せんきょう|ふなばし
気持	きもち
何者	なにもの
頭部	とうぶ
身内	みうち|しんない
物体	ぶったい
地酒	じざけ
早起き	はやおき
取組	とりくみ
音波	おんぱ
注入	ちゅうにゅう
反面	はんめん
遊べる	あそべる
決着	けっちゃく
対面	たいめん|だいめん
公平	こうへい
入所	にゅうしょ
物品	ぶっぴん
相方	あいかた
起用	きよう
真空	しんくう
感度	かんど
問合わせ	といあわせ
拾い	ひろい
次期	じき
乗り物	のりもの
曲目	きょくもく
期日	きじつ
死去	しきょ
役人	やくにん
遊園	ゆうえん
見物	けんぶつ|みもの
手持ち	てもち
事由	じゆう
日向	ひなた
終点	しゅうてん
王者	おうじゃ|おうしゃ
一員	いちいん
開会	かいかい
青葉	あおば
お守り	おまもり
作物	さくぶつ|さくもつ
先着	せんちゃく
集客	しゅうきゃく
持てる	もてる
通院	つういん
用具	ようぐ
流動	りゅうどう
全角	ぜんかく
農場	のうじょう
顔面	がんめん
調教	ちょうきょう
重ねる	かさねる
平面	へいめん
平行	へいこう
新緑	しんりょく
打者	だしゃ
転落	てんらく
真田	さなだ
持たせ	もたせ
作動	さどう
死後	しご
火事	かじ
化け	ばけ
図表	ずひょう
千代	せんだい|ちよ
終始	しゅうし
命中	めいちゅう
仕分け	しわけ
早急	さっきゅう|そうきゅう
旅人	たびびと|たびにん|りょじん
虫歯	むしば
使い勝手	つかいがって
薬品	やくひん
入れ歯	いれば
品目	ひんもく
筆頭	ひっとう|ふでがしら
商社	しょうしゃ
飲める	のめる
投げる	なげる
見送り	みおくり
品切れ	しなぎれ
短大	たんだい
夏祭り	なつまつり
本館	ほんかん
県外	けんがい
皮肉	ひにく
着実	ちゃくじつ
今期	こんき
一息	ひといき
和紙	わし
和牛	わぎゅう
陽子	ようし
羽根	はね|ばね
他国	たこく
直面	ちょくめん
意地	いじ
手打ち	てうち
定数	ていすう
内面	ないめん|うちづら
童話	どうわ
実名	じつめい|じつみょう
年次	ねんじ
分配	ぶんぱい
波動	はどう
水路	すいろ
真っ直ぐ	まっすぐ
暗黒	あんこく
区内	くない
文具	ぶんぐ
終える	おえる
大神	おおみかみ|だいじん
親指	おやゆび
重力	じゅうりょく
開運	かいうん
練り	ねり
引き受け	ひきうけ
落書き	らくがき
曲線	きょくせん
本命	ほんめい
動員	どういん
直感	ちょっかん
追放	ついほう
出世	しゅっせ
神道	しんとう
主題	しゅだい
取組み	とりくみ
打線	だせん
時事	じじ
水温	すいおん
当館	とうかん
実体	じったい|じってい
頭皮	とうひ
次いで	ついで
深める	ふかめる
見受け	みうけ
石橋	いしばし
品物	しなもの|しなもん
見所	みどころ
予言	よげん
食育	しょくいく
坂道	さかみち
屋内	おくない
短歌	たんか
川島	かわしま
苦しむ	くるしむ
着色	ちゃくしょく
定時	ていじ
院内	いんない
都度	つど
温室	おんしつ|うんしつ
談話	だんわ
出動	しゅつどう
表れ	あらわれ
整える	ととのえる
発作	ほっさ
名乗る	なのる
放流	ほうりゅう
根元	こんげん|ねもと
書物	かきもの|しょもつ
発する	はっする
酒場	さかば
次会	じかい
有数	ゆうすう
平家	ひらや
流星	ながれぼし|りゅうせい
始動	しどう
発着	はっちゃく
新橋	しんばし
持ち出し	もちだし
向く	むく
公安	こうあん
福音	ふくいん
局面	きょくめん
悪意	あくい
真っ暗	まっくら
多重	たじゅう
田植え	たうえ
一味	いちみ|ひとあじ
車庫	しゃこ
定めて	さだめて
等しい	ひとしい
全米	ぜんべい
石炭	せきたん
消去	しょうきょ
緑化	りょっか|りょくか
決心	けっしん
金具	かなぐ
読み取り	よみとり
全室	ぜんしつ
洋書	ようしょ
近世	きんせい
反転	はんてん
回想	かいそう
発車	はっしゃ
実写	じっしゃ
教委	きょうい
書式	しょしき
着工	ちゃっこう
泳ぐ	およぐ
商談	しょうだん
来院	らいいん
細部	さいぶ
重なる	かさなる
年配	ねんぱい
花屋	はなや
林業	りんぎょう
後世	こうせい|ごせ
発光	はっこう
面談	めんだん
楽章	がくしょう
中級	ちゅうきゅう
直進	ちょくしん
紙面	しめん
弱者	じゃくしゃ
帰路	きろ
真っ黒	まっくろ
泳ぎ	およぎ
消火	しょうか
使い分け	つかいわけ
取り外し	とりはずし
係数	けいすう
和書	わしょ
植木	うえき
想い出	おもいで
取消	とりけし
育毛	いくもう
三味線	しゃみせん
対岸	たいがん
昔話	むかしばなし
進入	しんにゅう
反動	はんどう
対人	たいじん
着うた	ちゃくうた
空調	くうちょう
全長	ぜんちょう
た感	たかん
着目	ちゃくもく
真っ先	まっさき
開館	かいかん
緑茶	りょくちゃ
他方	たほう
外相	がいしょう|げそう
助かる	たすかる
動力	どうりょく
行進	こうしん
受取	うけとり
流入	りゅうにゅう
等級	とうきゅう
去り	さり
全品	ぜんぴん
流用	りゅうよう
悲し	かなし
投球	とうきゅう
区切り	くぎり
電球	でんきゅう
注ぐ	そそぐ|つぐ
館長	かんちょう
二部	にぶ
実業	じつぎょう
勝ち組	かちぐみ
写メ	しゃめ
乗船	じょうせん
登用	とうよう
本業	ほんぎょう
朝起き	あさおき
長所	ちょうしょ
都立	とりつ
代わる	かわる
夏期	かき
商事	しょうじ
金庫	きんこ
送金	そうきん
品書き	しながき
起点	きてん
緑地	りょくち
読み返し	よみかえし
開口	かいこう
集う	つどう
乗り場	のりば
身の回り	みのまわり
返送	へんそう
小豆	あずき
和洋	わよう
打ち出し	うちだし
神事	しんじ
問いかけ	といかけ
一式	いっしき
手動	しゅどう
曲がり	まがり
代え	かえ|がえ
受理	じゅり
安らぎ	やすらぎ
買い取り	かいとり
平米	へいべい
度合い	どあい
中庭	なかにわ
上着	うわぎ
様相	ようそう
酒屋	さかや|ざかや
荷重	かじゅう|におも
主たる	しゅたる
乗せる	のせる
答申	とうしん
南向き	みなみむき
国有	こくゆう
学童	がくどう
洋風	ようふう
引き起こし	ひきおこし
学区	がっく
平山	ひらやま
配り	くばり
洋画	ようが
旅客	りょかく|りょきゃく
か所	かしょ
終り	おわり
想う	おもう
急ぐ	いそぐ
転生	てんしょう|てんせい
和歌	わか
宿命	しゅくめい
一転	いってん
仕草	しぐさ
原始	げんし
橋下	きょうか
放火	ほうか
医薬	いやく
鼻水	はなみず
空想	くうそう
大祭	たいさい
後部	こうぶ
動植物	どうしょくぶつ
死神	しにがみ
談合	だんごう
面会	めんかい
ゴミ箱	ごみばこ
重度	じゅうど
仕え	つかえ
商用	しょうよう
夕陽	ゆうひ
事後	じご
詩集	ししゅう
買取り	かいとり
見習い	みならい
風習	ふうしゅう
持ち物	もちもの
手助け	てだすけ
重なり	かさなり
水深	すいしん
小路	こうじ
指向	しこう
暗記	あんき
下品	げぼん|げひん
人身	じんしん|ひとみ
帰化	きか
台帳	だいちょう
乗れる	のれる
休息	きゅうそく
先代	せんだい
本題	ほんだい
温か	あたたか|あったか
飲み屋	のみや
万葉	まんよう
乗馬	じょうば
三宮	さんぐう
整合	せいごう
前身	ぜんしん
代用	だいよう
旅立ち	たびだち
定か	さだか
曲名	きょくめい
発進	はっしん
長者	ちょうじゃ
海面	かいめん|うなづら
神父	しんぷ
乗り入れ	のりいれ
所見	しょけん
打合せ	うちあわせ
波長	はちょう
商会	しょうかい
銀色	ぎんいろ|ぎんしょく
読み物	よみもの
着地	ちゃくち
来館	らいかん
長持ち	ながもち
打ち切り	うちきり
決め手	きめて
温水	おんすい
次女	じじょ
仕切り	しきり|じきり
悪人	あくにん
自発	じはつ
筆記	ひっき
申し入れ	もうしいれ
仕出し	しだし
県下	けんか
病理	びょうり
対等	たいとう
問答	もんどう
一安心	ひとあんしん
記帳	きちょう
待ち受け	まちうけ
水銀	すいぎん
向う	むかう|むこう
転売	てんばい
和え	あえ
対外	たいがい
遊具	ゆうぐ
申立て	もうしたて
登板	とうばん
美白	びはく
落ち葉	おちば
黒豆	くろまめ
休館	きゅうかん
分身	ぶんしん
落葉	らくよう|おちば
四球	しきゅう
持ち合わせ	もちあわせ
洋楽	ようがく
平ら	たいら|だいら
係員	かかりいん
次ぐ	つぐ
始発	しはつ
苦い	にがい
使者	ししゃ
楽屋	がくや
名乗り	なのり
大福	だいふく
温もり	ぬくもり
表題	ひょうだい
年表	ねんぴょう
県南	けんなん
育む	はぐくむ
使い道	つかいみち
平地	ひらち|へいち
本島	ほんとう
式場	しきじょう
古都	こと
新宮	しんぐう|しんみや
植林	しょくりん
曲がる	まがる
仕事場	しごとば
流行り	はやり|ばやり
悪役	あくやく
薬草	やくそう
足湯	あしゆ
前世	ぜんせ|ぜんせい
子守	こもり
葉山	はやま
真冬	まふゆ
山登り	やまのぼり
両足	りょうあし
申し立て	もうしたて
分化	ぶんか
仕入	しいれ
板金	いたがね|ばんきん
習い	ならい
横目	よこめ
代物	しろもの|だいぶつ|だいもつ
区長	くちょう
君主	くんしゅ
開校	かいこう
横丁	よこちょう
文集	ぶんしゅう
自重	じちょう|じじゅう
茶葉	ちゃば
仕上げる	しあげる
局所	きょくしょ
血行	けっこう
起算	きさん
湯船	ゆぶね
時速	じそく
終日	ひもすがら|しゅうじつ
海運	かいうん
重心	じゅうしん
同感	どうかん
後味	あとあじ
真心	まごころ
旅先	たびさき
対局	たいきょく
持たせる	もたせる
組曲	くみきょく
引き取り	ひきとり
宿場	しゅくば
同和	どうわ
和子	わこ
間取	まどり
病室	びょうしつ
聞き取り	ききとり
感知	かんち
ラー油	らーゆ
楽勝	らくしょう
文面	ぶんめん
勝者	しょうしゃ
他人事	ひとごと
申出	もうしで
父様	とうさま
軽やか	かるやか|かろやか
追っかけ	おっかけ
地主	じぬし
毛皮	けがわ
流体	りゅうたい
薬用	やくよう
申立	もうしたて
五感	ごかん
美化	びか
円安	えんやす
一服	いっぷく
発育	はついく
定住	ていじゅう
当主	とうしゅ
全線	ぜんせん
電柱	でんちゅう
実り	みのり
当期	とうき
校庭	こうてい
界面	かいめん
祭神	さいじん
国庫	こっこ
教習	きょうしゅう
有明	ありあけ
来客	らいきゃく
次長	じちょう
自負	じふ
拾う	ひろう
物色	ぶっしょく
着こなし	きこなし
本県	ほんけん
取消し	とりけし
白銀	しろがね|はくぎん
有事	ゆうじ
調書	ちょうしょ
取りあえず	とりあえず
明神	あきつかみ|みょうじん
歯ごたえ	はごたえ
寒天	かんてん
打球	だきゅう
真意	しんい
通帳	つうちょう|かよいちょう
予知	よち
対向	たいこう
重たい	おもたい
かけ流し	かけながし
田畑	たはた|でんぱた
本宮	ほんぐう
着メロ	ちゃくめろ
送り出し	おくりだし
仕業	しわざ|しぎょう
放電	ほうでん
お化け	おばけ
転写	てんしゃ
意地悪	いじわる
勝る	まさる
同調	どうちょう
金物	かなもの
切実	せつじつ
決行	けっこう
病人	びょうにん
出向	しゅっこう
上等	じょうとう
開場	かいじょう
悪用	あくよう
部数	ぶすう
有様	ありさま
取り直し	とりなおし
見落とし	みおとし
鉄人	てつじん
待ち遠しい	まちどおしい
洋室	ようしつ
根気	こんき
究明	きゅうめい
入部	にゅうぶ
横顔	よこがお
文様	もんよう
転向	てんこう
切開	せっかい
八重	やえ
中等	ちゅうとう
通商	つうしょう
苦味	くみ|にがみ
打開	だかい
発声	はっせい
生死	せいし|しょうし|しょうじ
交配	こうはい
持ち運び	もちはこび
引き返し	ひきかえし
火薬	かやく
和服	わふく
係長	かかりちょう
出所	しゅっしょ|でどころ
全校	ぜんこう
実話	じつわ
身元	みもと
予習	よしゅう
横手	よこて|よこで
手放し	てばなし
上乗せ	うわのせ
終身	しゅうしん
会期	かいき
歯車	はぐるま
入館	にゅうかん
発色	はっしょく
下宿	げしゅく
指南	しなん
取りまとめ	とりまとめ
有線	ゆうせん
駅員	えきいん
開港	かいこう
前列	ぜんれつ
地消	ちしょう
血流	けつりゅう
他所	たしょ|よそ
助け合い	たすけあい
葉書	はがき
美学	びがく
切れ味	きれあじ
植える	うえる
小指	こゆび
代打	だいだ
化け物	ばけもの
金運	きんうん
申す	もうす
有形	ゆうけい
足取り	あしとり|あしどり
持ち味	もちあじ
病名	びょうめい
黒板	こくばん
長屋	ながや
先取り	さきどり
打てる	うてる
落し	おとし
先送り	さきおくり
和平	わへい
半身	はんしん|はんみ
急落	きゅうらく
親身	しんみ
花言葉	はなことば
地表	ちひょう
あの世	あのよ
根っこ	ねっこ
病原	びょうげん
葉月	はづき
酒店	さけてん|しゅてん
寒気	さむけ|かんき
主食	しゅしょく
女流	じょりゅう
生薬	しょうやく|きぐすり
美食	びしょく
発病	はつびょう
予期	よき
医大	いだい
配る	くばる
古着	ふるぎ
一路	いちろ
部外	ぶがい
走者	そうしゃ
全曲	ぜんきょく
かき氷	かきごおり
終電	しゅうでん
気品	きひん
対する	たいする
写り	うつり
三世	みよ
大昔	おおむかし
同県	どうけん
安物	やすもの
負け犬	まけいぬ
着ぐるみ	きぐるみ
木の実	きのみ|このみ
本意	ほんい
遊び心	あそびごころ
遊び場	あそびば
年始	ねんし
秒間	びょうかん
部族	ぶぞく
白身	しろみ|はくしん
転校	てんこう
真下	ました
口実	こうじつ
取り返し	とりかえし
歯肉	はにく
駅間	えきかん
和やか	なごやか
返り	かえり|がえり
船員	せんいん
波形	なみがた|はけい
気配り	きくばり
前歯	まえば
相乗	そうじょう
耳鼻	じび
面子	めんこ|めんつ
美形	びけい
見返し	みかえし
女医	じょい
室温	しつおん
重合	じゅうごう
絵の具	えのぐ
題目	だいもく
両社	りょうしゃ
童子	どうじ
区立	くりつ
転入	てんにゅう
軽食	けいしょく
植生	しょくせい
運気	うんき
全土	ぜんど
身動き	みうごき
真中	まんなか
部局	ぶきょく
直筆	じきひつ|ちょくひつ
本流	ほんりゅう
等身	とうしん
温める	あたためる|ぬくめる|ぬるめる
太平	たいへい
見返り	みかえり
平原	へいげん
取り方	とりかた
出港	しゅっこう
定理	ていり
消息	しょうそく
山羊	やぎ
悪し	あし
港町	みなとまち
同定	どうてい
悪寒	おかん
食い物	くいもの
売主	うりぬし
命題	めいだい
習う	ならう|なろう
助長	じょちょう
放し	はなし|ほかし|ぱなし
度数	どすう
魚屋	さかなや
鼻血	はなじ
行者	ぎょうじゃ
他県	たけん
第一線	だいいっせん
深海	しんかい
同業	どうぎょう
短所	たんしょ
流水	りゅうすい
他店	たてん
平年	へいねん
箱入り	はこいり
見苦しい	みぐるしい
鉄分	てつぶん
色調	しきちょう
球根	きゅうこん
和み	なごみ
入港	にゅうこう
次号	じごう
医科	いか
県人	けんじん
勝ち点	かちてん
自決	じけつ
根強い	ねづよい
追い出し	おいだし
図式	ずしき
受かる	うかる
祭礼	さいれい
長身	ちょうしん
相反	そうはん
真弓	まゆみ
湯気	ゆげ
花畑	はなばたけ
合言葉	あいことば
全日	ぜんじつ|ぜんにち
細身	ほそみ
子役	こやく
真っ青	まっさお
原酒	げんしゅ
暑中	しょちゅう
係り	かかわり|かかり|がかり
有意	ゆうい
左岸	さがん
銀山	ぎんざん
通所	つうしょ
一代	いちだい
神学	しんがく
一様	いちよう
駅近	えきちか
家主	やぬし|いえぬし|いえあるじ
深まる	ふかまる
和光	わこう
薬事	やくじ
開局	かいきょく
助っ人	すけっと
部室	ぶしつ
軽度	けいど
立命	りつめい
配色	はいしょく
木の葉	このは
決起	けっき
生き様	いきざま
一昔	ひとむかし
取手	とって|とりて
両日	りょうじつ
名神	めいしん
数式	すうしき
同乗	どうじょう
読取	よみとり
配下	はいか
死人	しにん|しびと
命日	めいにち
書院	しょいん
王宮	おうきゅう
右岸	うがん
対日	たいにち
根ざし	ねざし
安らか	やすらか
真上	まうえ
申し分	もうしぶん
横行	おうこう
返上	へんじょう
歯止め	はどめ
調合	ちょうごう
受入	うけいれ
回遊	かいゆう
開園	かいえん
一等	いっとう
二世	にせ
校区	こうく
宮内	くない
宿る	やどる
負け組	まけぐみ
大勝	たいしょう
送電	そうでん
冬期	とうき
上院	じょういん
起立	きりつ
全う	まっとう
前号	ぜんごう
新調	しんちょう
同化	どうか
運休	うんきゅう
売り物	うりもの
悪者	わるもの
動ける	うごける
県北	けんほく
実地	じっち
歌集	かしゅう
仕える	つかえる
気取り	きどり|けどり
品等	ひんとう
天板	てんばん|てんいた
持分	もちぶん
外注	がいちゅう
画集	がしゅう
勝目	かちめ
安売り	やすうり
漢文	かんぶん
薬味	やくみ
投げかけ	なげかけ
乗組	のりくみ
流氷	りゅうひょう
神起	しんき
風化	ふうか
血中	けっちゅう
送れる	おくれる
薬学	やくがく
身勝手	みがって
住戸	じゅうこ
悪事	あくじ
内湯	うちゆ
反感	はんかん
宮中	きゅうちゅう
味見	あじみ
発毛	はつもう
水遊び	みずあそび
三十路	みそじ
整数	せいすう
直球	ちょっきゅう
高所	こうしょ
研ぎ	とぎ
受動	じゅどう
名勝	めいしょう
祭日	さいじつ
表向き	おもてむき
米屋	こめや
見開き	みひらき
転がし	ころがし|まろがし
二期	にき
全社	ぜんしゃ
打点	だてん
金銀	きんぎん
仕立	したて|じたて
院生	いんせい
開山	かいさん|かいざん
下院	かいん
炭化	たんか
神主	かんぬし
農道	のうどう
子持ち	こもち
手取り	てとり|てどり
乗り心地	のりごこち
来期	らいき
氷室	ひむろ|ひょうしつ
品番	しなばん|ひんばん
万事	ばんじ
神明	しんめい
学業	がくぎょう
受け皿	うけざら
天守	てんしゅ
ひな祭り	ひなまつり
客船	きゃくせん
強者	きょうしゃ
他界	たかい
八百屋	やおや
まな板	まないた
球体	きゅうたい
神代	かみよ|じんだい
秋祭り	あきまつり
皮切り	かわきり
客車	きゃくしゃ
追い風	おいかぜ
化物	ばけもの
野宿	のじゅく
後進	こうしん
中指	なかゆび
想起	そうき
風速	ふうそく
和名	わめい|わみょう
平屋	ひらや
書庫	しょこ
国定	こくてい
放水	ほうすい
起し	おこし
一丁	いっちょう
年式	ねんしき
東宮	とうぐう
鉄橋	てっきょう
安楽	あんらく
仕事人	しごとにん
対空	たいくう
湯本	ゆもと
引取	ひきとり
生身	なまみ
相生	あいおい|そうしょう
使い物	つかいもの
名湯	めいとう
転がり	ころがり
集金	しゅうきん
風流	ふうりゅう
写る	うつる
中長期	ちゅうちょうき
陽光	ようこう
ぬるま湯	ぬるまゆ
注力	ちゅうりょく
上向き	うわむき
命がけ	いのちがけ
羽化	うか
自習	じしゅう
中流	ちゅうりゅう
手品	てじな
身代わり	みがわり
一期	いちご
下取り	したどり
洋館	ようかん
下り坂	くだりざか
合板	ごうはん|ごうばん
発火	はっか
係わる	かかわる
後発	こうはつ
中和	ちゅうわ
新館	しんかん
人命	じんめい
酒飲み	さけのみ
真言	しんごん
流れ星	ながれぼし
一世	いっせ|いっせい
高次	こうじ
小部屋	こべや
所用	しょよう
指さし	ゆびさし
商号	しょうごう
宿屋	やどや
取水	しゅすい
新薬	しんやく
着ける	つける|づける
草の根	くさのね
意気	いき|いく
心待ち	こころまち
後ろ向き	うしろむき
取り調べ	とりしらべ
定形	ていけい
調度	ちょうど
転出	てんしゅつ
油絵	あぶらえ
次代	じだい
美男	びなん
急坂	きゅうざか|きゅうはん
住まいづくり	すまいづくり
歯石	しせき
主語	しゅご
旅立つ	たびだつ
着心地	きごこち
終い	しまい|じまい
等分	とうぶん
道州	どうしゅう
手相	てそう
公庫	こうこ
九重	ここのえ
家業	かぎょう
漢詩	かんし|からうた
大流行	おおはやり|だいりゅうこう
多面	ためん
万物	ばんぶつ|よろずもの
整い	ととのい
生業	せいぎょう|なりわい
前駅	ぜんえき
美ら	ちゅら
島内	とうない
水流	すいりゅう
気球	ききゅう
取り合い	とりあい
歌曲	かきょく
新都	しんと
有人	ゆうじん
軽油	けいゆ
名品	めいひん
肉屋	にくや
真っ向	まっこう
取っ手	とって
屋号	やごう
回送	かいそう
乗員	じょういん
町屋	まちや
時短	じたん
受入れ	うけいれ
死語	しご
代引	だいびき
駅ビル	えきびる
和音	わおん
歯列	しれつ
農水	のうすい
美顔	びがん
息切れ	いきぎれ
取り引き	とりひき
取り立て	とりたて
下級	かきゅう
投薬	とうやく
終る	おわる
持病	じびょう
上面	うわつら|じょうめん
直流	ちょくりゅう
気流	きりゅう
手の平	てのひら
物言い	ものいい
勝ち負け	かちまけ
何物	なにもの
深まり	ふかまり
同族	どうぞく
悲しむ	かなしむ
表皮	ひょうひ
飲用	いんよう
急登	きゅうとう
庭木	にわき
取り合えず	とりあえず
転がる	ころがる
羊毛	ようもう
次ぎ	つぎ
名医	めいい
湯葉	ゆば
大曲	たいきょく
名取	なとり
朝礼	ちょうれい
世相	せそう
山岸	やまぎし
大乗	だいじょう
員数	いんずう
予後	よご
写す	うつす
死角	しかく
一期一会	いちごいちえ
安っぽい	やすっぽい
対米	たいべい
反落	はんらく
深度	しんど
病死	びょうし
湖面	こめん
上皮	うわかわ|じょうひ
転身	てんしん
品名	ひんめい
子息	しそく
命ずる	めいずる
竹炭	ちくたん
一役	ひとやく
一助	いちじょ
急所	きゅうしょ
配役	はいやく
入湯	にゅうとう
赤面	せきめん|あかづら
始業	しぎょう
駅長	えきちょう
荷台	にだい
食味	しょくみ
面目	めんぼく|めんもく
物語る	ものがたる
寒波	かんぱ
注記	ちゅうき
守れる	まもれる
油田	ゆでん
君子	くんし
色使い	いろづかい
商い	あきない
知育	ちいく
旅路	たびじ
今昔	こんじゃく
深山	しんざん|みやま
化す	かす
助役	じょやく
神子	みこ
流木	りゅうぼく
身軽	みがる
返る	かえる
ひと味	ひとあじ
整列	せいれつ
和む	なごむ
湖北	こほく
五味	ごみ
手放す	てばなす
落花生	らっかせい
古式	こしき
分業	ぶんぎょう
向き合い	むきあい
全勝	ぜんしょう
工期	こうき
両目	りょうめ
小橋	こばし
定点	ていてん
真横	まよこ
化身	けしん
度重なる	たびかさなる
岩屋	いわや
反米	はんべい
苦言	くげん
新酒	しんしゅ
配水	はいすい
開国	かいこく
王族	おうぞく
赤身	あかみ
薬指	くすりゆび
月面	げつめん
落着	らくちゃく|らくじゃく
大洋	たいよう
引受	ひきうけ
全話	ぜんわ
死ねる	しねる
真木	まき
商船	しょうせん
屋形船	やかたぶね
主君	しゅくん
引き落とし	ひきおとし
電荷	でんか
神前	しんぜん
遊女	ゆうじょ
語り部	かたりべ
形相	ぎょうそう|けいそう
自他	じた
速読	そくどく
号外	ごうがい
年号	ねんごう
音速	おんそく
明暗	めいあん
反り	そり|ぞり
波乗り	なみのり
使い手	つかいて
重き	おもき
外界	がいかい
身上	しんしょう|しんじょう
三流	さんりゅう
お日様	おひさま
入庫	にゅうこ
県内外	けんないがい
日進	にっしん
命じる	めいじる
強打	きょうだ
仕打ち	しうち
油分	ゆぶん
倍速	ばいそく
通期	つうき
物音	ものおと
仕上	しあげ
湯元	ゆもと
先客	せんきゃく
下界	かかい|げかい
悪行	あっこう|あくぎょう
くり返し	くりかえし
神体	しんたい
切り返し	きりかえし
安上がり	やすあがり
見向き	みむき
原曲	げんきょく
主事	しゅじ
取り決め	とりきめ
次週	じしゅう
小品	しょうひん
短パン	たんぱん
庭先	にわさき
教区	きょうく
手指	しゅし
死す	しす
球界	きゅうかい
横ばい	よこばい
重荷	おもに
上り坂	のぼりざか
入植	にゅうしょく
進級	しんきゅう
同列	どうれつ
同表	どうひょう
客員	かくいん|きゃくいん
家路	いえじ
長調	ちょうちょう
品数	しなかず
草取り	くさとり
豆まき	まめまき
定植	ていしょく
勉学	べんがく
追究	ついきゅう
事物	じぶつ
色味	いろみ
相反する	あいはんする
陽だまり	ひだまり
安で	やすで
用命	ようめい
真っ当	まっとう
同院	どういん
親和	しんわ
代り	かわり|がわり
西岸	せいがん
子安	こやす
黄身	きみ
茶の湯	ちゃのゆ
氷上	ひょうじょう
曲げる	まげる
使い心地	つかいごこち
聞き流し	ききながし
内服	ないふく
引取り	ひきとり
神木	しんぼく
動かせる	うごかせる
仕返し	しかえし
軽トラ	けいとら
面持ち	おももち
一筆	いっぴつ|ひとふで
自筆	じひつ
真人	しんじん|まひと
急死	きゅうし
むし歯	むしば
飲茶	やむちゃ|いんさ
洋式	ようしき
局員	きょくいん
馬主	ばしゅ
安住	あんじゅう
服薬	ふくやく
詩歌	しいか|しか
送球	そうきゅう
横たわる	よこたわる
練る	ねる
味気	あじき|あじけ
写本	しゃほん
代役	だいやく
終業	しゅうぎょう
全店	ぜんてん
母屋	おもや|もや
仕入れる	しいれる
深部	しんぶ
温まる	あたたまる|ぬくまる
全館	ぜんかん
開帳	かいちょう|がいちょう
曲集	きょくしゅう
雨具	あまぐ
川遊び	かわあそび
短調	たんちょう
八丁	はっちょう
重箱	じゅうばこ
両院	りょういん
落石	らくせき
感服	かんぷく
口笛	くちぶえ
進言	しんげん
物心	ぶっしん|ものごころ
流血	りゅうけつ
追い上げ	おいあげ
木箱	きばこ
大葉	おおば
重体	じゅうたい
登れる	のぼれる
パチ屋	ぱちや
習字	しゅうじ
乗合	のりあい
川岸	かわぎし
両岸	りょうがん
重ね合わせ	かさねあわせ
宿主	しゅくしゅ|やどぬし
酒気	さかけ|しゅき
宮地	みやどころの
自助	じじょ
植毛	しょくもう
島国	しまぐに
持ち前	もちまえ
っ放し	っぱなし
決死	けっし
持ち手	もちて
小皿	こざら
外面	がいめん|げめん|そとづら
横向き	よこむき
白根	しらね
天界	てんかい|てんがい
勝間	かつま
真顔	まがお
部内	ぶない
曲調	きょくちょう
切り取り	きりとり
名指し	なざし
乗っ取り	のっとり
住める	すめる
取調べ	とりしらべ
所作	しょさ
新進	しんしん
年祭	ねんさい
他校	たこう
病弱	びょうじゃく
取り下げ	とりさげ
重油	じゅうゆ
所内	しょない
落ちこぼれ	おちこぼれ
山神	さんしん|さんじん
列強	れっきょう
同号	どうごう
切り身	きりみ
手仕事	てしごと
風向き	かざむき|かぜむき
向日	こうじつ
横切る	よこぎる
局地	きょくち
丸投げ	まるなげ
持ち直し	もちなおし
仕上がる	しあがる
全道	ぜんどう
追分	おいわけ
苦心	くしん
平方	へいほう
転ぶ	ころぶ
光速	こうそく
流行る	はやる
悪気	わるぎ
乗用	じょうよう
鉄工	てっこう
全会	ぜんかい
石坂	いしざか
医局	いきょく
手打	てうち
地平	ちへい
音階	おんかい
帰着	きちゃく
頭取	とうどり
急きょ	きゅうきょ
土着	どちゃく
面する	めんする
委員会	いいんかい
何度	なんど
主人公	しゅじんこう
図書館	としょかん
研究所	けんきゅうしょ|けんきゅうじょ
商取引	しょうとりひき
事業者	じぎょうしゃ
委員長	いいんちょう
第三者	だいさんしゃ
面白	おもしろ
研究会	けんきゅうかい
飲食店	いんしょくてん
世界中	せかいじゅう
歯医者	はいしゃ
大学院	だいがくいん
研究者	けんきゅうしゃ
市役所	しやくしょ
事業所	じぎょうしょ
日本酒	にほんしゅ
期間中	きかんちゅう
旅行記	りょこうき
問題点	もんだいてん
写真集	しゃしんしゅう
正社員	せいしゃいん
理事長	りじちょう
医薬品	いやくひん
研究室	けんきゅうしつ
発売日	はつばいび
代理店	だいりてん
有名人	ゆうめいじん
運転手	うんてんしゅ
出品者	しゅっぴんしゃ
動物園	どうぶつえん
今年度	こんねんど
体育館	たいいくかん
当事者	とうじしゃ
太陽光	たいようこう
全日本	ぜんにっぽん|ぜんにほん
発表会	はっぴょうかい
次世代	じせだい
同級生	どうきゅうせい
勉強会	べんきょうかい
暗号化	あんごうか
運動会	うんどうかい
王様	おうさま
新商品	しんしょうひん
文字列	もじれつ
所有者	しょゆうしゃ
定休日	ていきゅうび
短時間	たんじかん
代表者	だいひょうしゃ
美少女	びしょうじょ
組合員	くみあいいん
医学部	いがくぶ
理事会	りじかい
水族館	すいぞくかん
予定日	よていび
化合物	かごうぶつ
用語集	ようごしゅう
日用品	にちようひん
事実上	じじつじょう
交流会	こうりゅうかい
発電所	はつでんしょ
主題歌	しゅだいか
登山口	とざんぐち
下半身	かはんしん
家庭用	かていよう
大部分	だいぶぶん
代理人	だいりにん
電話帳	でんわちょう
短期間	たんきかん
取引所	とりひきしょ|とりひきじょ
会社員	かいしゃいん
回答者	かいとうしゃ
相談所	そうだんしょ|そうだんじょ
工作員	こうさくいん
先進国	せんしんこく
県知事	けんちじ
知名度	ちめいど
来年度	らいねんど
一時期	いちじき
放送局	ほうそうきょく
取引先	とりひきさき
文化祭	ぶんかさい
研究科	けんきゅうか
発売中	はつばいちゅう
野球部	やきゅうぶ
注意点	ちゅういてん
科学者	かがくしゃ
使用者	しようしゃ
写真館	しゃしんかん
公開中	こうかいちゅう
作曲家	さっきょくか
遊歩道	ゆうほどう
漢方薬	かんぽうやく
四半期	しはんき
長期間	ちょうきかん
少子化	しょうしか
遊園地	ゆうえんち
大使館	たいしかん
乗用車	じょうようしゃ
一級	いっきゅう
商工会	しょうこうかい
開発者	かいはつしゃ
予想外	よそうがい
研究員	けんきゅういん
大都市	だいとし
生放送	なまほうそう
事業部	じぎょうぶ
意見書	いけんしょ
古本屋	ふるほんや
本年度	ほんねんど
写真家	しゃしんか
上半身	じょうはんしん
歩行者	ほこうしゃ
出身者	しゅっしんしゃ
軽自動車	けいじどうしゃ
多様化	たようか
前年度	ぜんねんど
安心感	あんしんかん
出身地	しゅっしんち
事業主	じぎょうぬし
仕事中	しごとちゅう
中央線	ちゅうおうせん
実用化	じつようか
真夜中	まよなか
近代化	きんだいか
教習所	きょうしゅうじょ
区役所	くやくしょ
生物学	せいぶつがく
旅行者	りょこうしゃ
起業家	きぎょうか
工事中	こうじちゅう
入学式	にゅうがくしき
問題集	もんだいしゅう
商品化	しょうひんか
代表作	だいひょうさく
一人旅	ひとりたび
正当化	せいとうか
植物園	しょくぶつえん
思春期	ししゅんき
作品集	さくひんしゅう
活動中	かつどうちゅう
大集合	だいしゅうごう
海岸線	かいがんせん
一体化	いったいか
相手方	あいてがた
期間内	きかんない
部活動	ぶかつどう
小売業	こうりぎょう
様子見	ようすみ
来場者	らいじょうしゃ
本部長	ほんぶちょう
地上波	ちじょうは
開会式	かいかいしき
都市部	としぶ
自動化	じどうか
生活者	せいかつしゃ
上級者	じょうきゅうしゃ
中央部	ちゅうおうぶ
物理学	ぶつりがく
使用感	しようかん
自由度	じゆうど
新発売	しんはつばい
工学部	こうがくぶ
練習場	れんしゅうじょう
合理化	ごうりか
進行中	しんこうちゅう
開放感	かいほうかん
待合室	まちあいしつ
生意気	なまいき
研究家	けんきゅうか
人気者	にんきもの
山小屋	やまごや
生命力	せいめいりょく
手作業	てさぎょう
登山者	とざんしゃ
作業員	さぎょういん
風物詩	ふうぶつし
放送中	ほうそうちゅう
正反対	せいはんたい
教育長	きょういくちょう
部屋数	へやかず
青年部	せいねんぶ
感想文	かんそうぶん
農作物	のうさくもつ
町役場	まちやくば
安定感	あんていかん
安定所	あんていしょ
新年度	しんねんど
古事記	こじき
科学館	かがくかん
中古品	ちゅうこひん
作業中	さぎょうちゅう
農作業	のうさぎょう
小動物	しょうどうぶつ
万葉集	まんようしゅう
行動力	こうどうりょく
開発中	かいはつちゅう
歯科医	しかい
原動力	げんどうりょく
学園祭	がくえんさい
原作者	げんさくしゃ
元首相	もとしゅしょう
文学部	ぶんがくぶ
都知事	とちじ
音楽祭	おんがくさい
番組表	ばんぐみひょう
安定化	あんていか
入院中	にゅういんちゅう
内定者	ないていしゃ
電気代	でんきだい
三者	さんしゃ
具体化	ぐたいか
出発点	しゅっぱつてん
自由化	じゆうか
家庭内	かていない
開始日	かいしび
文庫本	ぶんこぼん
一部分	いちぶぶん
真正面	ましょうめん|まっしょうめん
作業所	さぎょうしょ
鉄道駅	てつどうえき
炭水化物	たんすいかぶつ
七福神	しちふくじん
白血病	はっけつびょう
同世代	どうせだい
野球場	やきゅうじょう
注目度	ちゅうもくど
高度化	こうどか
相談員	そうだんいん
顔写真	かおしゃしん
新登場	しんとうじょう
小道具	こどうぐ
食事会	しょくじかい
生命体	せいめいたい
耳鼻科	じびか
出発日	しゅっぱつび
外科医	げかい
次回作	じかいさく
後頭部	こうとうぶ
運動場	うんどうじょう
親近感	しんきんかん
落語家	らくごか
体育祭	たいいくさい
活動家	かつどうか
地球人	ちきゅうじん
上半期	かみはんき
体育会	たいいくかい
大公開	だいこうかい
学習者	がくしゅうしゃ
心意気	こころいき
回転数	かいてんすう
活発化	かっぱつか
等身大	とうしんだい
使用人	しようにん
交通局	こうつうきょく
相談者	そうだんしゃ
定食屋	ていしょくや
運転者	うんてんしゃ
日記帳	にっきちょう
万年筆	まんねんひつ
同年代	どうねんだい
高速化	こうそくか
予定者	よていしゃ
乗組員	のりくみいん
開口部	かいこうぶ
作品名	さくひんめい
角部屋	かどべや
運転中	うんてんちゅう
決算書	けっさんしょ
発送日	はっそうび
新世界	しんせかい
同業者	どうぎょうしゃ
絵葉書	えはがき
農業者	のうぎょうしゃ
配送先	はいそうさき
茶道具	ちゃどうぐ
進学校	しんがくこう
練習中	れんしゅうちゅう
弱体化	じゃくたいか
多方面	たほうめん
正会員	せいかいいん
仕様書	しようしょ
注文日	ちゅうもんび
電子化	でんしか
歩道橋	ほどうきょう
高感度	こうかんど
開業医	かいぎょうい
発行者	はっこうしゃ
休館日	きゅうかんび
役員会	やくいんかい
間取図	まどりず
入所者	にゅうしょしゃ
水平線	すいへいせん
西海岸	にしかいがん
美少年	びしょうねん
配当金	はいとうきん
工作物	こうさくぶつ
事業化	じぎょうか
一本化	いっぽんか
福音書	ふくいんしょ
期待感	きたいかん
実業家	じつぎょうか
見放題	みほうだい
世話人	せわにん
目薬	めぐすり
北西部	ほくせいぶ
前夜祭	ぜんやさい
向上心	こうじょうしん
手荷物	てにもつ
高級車	こうきゅうしゃ
温度計	おんどけい
会員数	かいいんすう
事業場	じぎょうじょう
教育者	きょういくしゃ
実力者	じつりょくしゃ
地平線	ちへいせん
想定外	そうていがい
白血球	はっけっきゅう
生息地	せいそくち
予定表	よていひょう
一元化	いちげんか
旅行先	りょこうさき
理学部	りがくぶ
入場者	にゅうじょうしゃ
集合体	しゅうごうたい
練習会	れんしゅうかい
新世代	しんせだい
用水路	ようすいろ
人一倍	ひといちばい
流行語	りゅうこうご
思想家	しそうか
南西部	なんせいぶ
家庭科	かていか
文学者	ぶんがくしゃ
赤血球	せっけっきゅう
行進曲	こうしんきょく
大都会	だいとかい
作業場	さぎょうば
入学者	にゅうがくしゃ
血小板	けっしょうばん
作曲者	さっきょくしゃ
表面化	ひょうめんか
転校生	てんこうせい
定年後	ていねんご
通学路	つうがくろ
細分化	さいぶんか
北東部	ほくとうぶ
学会員	がっかいいん
十字路	じゅうじろ
都心部	としんぶ
次年度	じねんど
実生活	じっせいかつ
寺子屋	てらこや
文学館	ぶんがくかん
宿場町	しゅくばまち
年度内	ねんどない
地理院	ちりいん
氷点下	ひょうてんか
談話室	だんわしつ
計算式	けいさんしき
定形外	ていけいがい
数学者	すうがくしゃ
同行者	どうこうしゃ
農学部	のうがくぶ
発起人	ほっきにん
玉手箱	たまてばこ
使命感	しめいかん
進行形	しんこうけい
全国区	ぜんこくく
病原体	びょうげんたい
洋食屋	ようしょくや
全自動	ぜんじどう