利用	りよう
必要	ひつよう
以上	いじょう
登録	とうろく
良い	いい|よい
最近	さいきん
関係	かんけい
好き	すき|ずき
参加	さんか
方法	ほうほう
結果	けっか
管理	かんり
無料	むりょう
無い	ない
料理	りょうり
関連	かんれん
説明	せつめい
最後	さいご
追加	ついか
以下	いか
案内	あんない
以外	いがい
初めて	はじめて
自然	しぜん|じねん
周辺	しゅうへん
特に	とくに
予約	よやく
求人	きゅうじん
不動産	ふどうさん
最初	さいしょ
健康	けんこう
最新	さいしん
昨日	きのう|さくじつ
選手	せんしゅ
希望	きぼう
目的	もくてき
大変	たいへん
観光	かんこう
続き	つづき
体験	たいけん
作成	さくせい
良く	よく
友達	ともだち
以前	いぜん
機関	きかん
特別	とくべつ
重要	じゅうよう
試合	しあう|しあい|じあい
付け	つけ|づけ
付き	つき|づき
種類	しゅるい
料金	りょうきん
最高	さいこう
法人	ほうじん
記念	きねん
特定	とくてい
参考	さんこう
送料	そうりょう
必ず	かならず
完全	かんぜん
国民	こくみん|くにたみ
求め	もとめ
結局	けっきょく
協力	きょうりょく
最大	さいだい
無理	むり
大好き	だいすき
変化	へんか|へんげ
最終	さいしゅう
市民	しみん
英語	えいご
位置	いち
労働	ろうどう
生産	せいさん
名無し	ななし
徒歩	とほ
会議	かいぎ
特集	とくしゅう
便利	べんり
試験	しけん
記録	きろく
成長	せいちょう
戦争	せんそう
当然	とうぜん
以内	いない
通信	つうしん
残念	ざんねん
仲間	なかま
昨年	さくねん
満足	まんぞく
産業	さんぎょう
覚え	おぼえ
野菜	やさい
成功	せいこう
議員	ぎいん
季節	きせつ
小説	しょうせつ
生徒	せいと
選挙	せんきょ
最も	もっとも|いとも
完成	かんせい
変え	かえ|がえ
不安	ふあん
機会	きかい
投票	とうひょう
各種	かくしゅ
全然	ぜんぜん
送信	そうしん
建物	たてもの|たてもん
不思議	ふしぎ
協会	きょうかい
周り	まわり
課題	かだい
目標	もくひょう
受付	うけつけ
例えば	たとえば
香り	かおり
伝え	つたえ
加工	かこう
共同	きょうどう
連れ	つれ|づれ
改正	かいせい
連続	れんぞく
感覚	かんかく
焼き	やき
未来	みらい
努力	どりょく
続く	つづく
失敗	しっぱい
試し	ためし|だめし
笑顔	えがお
住民	じゅうみん
卒業	そつぎょう
印刷	いんさつ
馬鹿	ばか
続ける	つづける
風景	ふうけい
公共	こうきょう
機械	きかい
配信	はいしん
選び	えらび
実験	じっけん
参照	さんしょう
以来	いらい
材料	ざいりょう
残り	のこり
不明	ふめい
受験	じゅけん
機器	きき
老人	ろうじん
ご飯	ごはん
低い	ひくい|ひきい
無し	なし
付近	ふきん
固定	こてい
選ん	えらん|よん|えん
戦い	おののい|そよい|たたかい
無事	ぶじ
変わる	かわる
天然	てんねん
児童	じどう
大量	たいりょう
協議	きょうぎ
要望	ようぼう
形成	けいせい
不足	ふそく|ぶそく
静か	しずか
変わり	かわり|がわり
好み	このみ|ごのみ
願い	ねがい
大臣	おおおみ|おとど|だいじん
求める	もとめる
選ぶ	えらぶ
初期	しょき
自信	じしん
取材	しゅざい
借り	かり|がり
人材	じんざい
約束	やくそく
共通	きょうつう
手続き	てつづき
要求	ようきゅう
積極	せっきょく
勝利	しょうり
建て	たて|だて
散歩	さんぽ
各地	かくち
成分	せいぶん
事例	じれい
辺り	あたり
返信	へんしん
笑い	わらい
成果	せいか
育成	いくせい
働き	はたらき|ばたらき
周年	しゅうねん
観察	かんさつ
残る	のこる
必死	ひっし
初め	そめ|はじめ
書類	しょるい
伝説	でんせつ
訓練	くんれん
民主	みんしゅ
単位	たんい
当初	とうしょ
達成	たっせい
改めて	あらためて
関心	かんしん
働く	はたらく
失礼	しつれい
民間	みんかん
発信	はっしん
民族	みんぞく
成立	せいりつ
共有	きょうゆう
別れ	わかれ
変える	かえる
都道府県	とどうふけん
主要	しゅよう
低下	ていか
最低	さいてい
出席	しゅっせき
差別	さべつ|しゃべつ
面積	めんせき
競争	きょうそう
連合	れんごう
特典	とくてん
挙げ	あげ
食材	しょくざい
有料	ゆうりょう
飛ん	とべん|とん
配置	はいち
栄養	えいよう
信号	しんごう
苦労	くろう|ぐろう
楽器	がっき
景色	けしき|げしき
不要	ふよう
分類	ぶんるい
作戦	さくせん
土産	みやげ|どさん
週末	しゅうまつ
工夫	くふう|こうふ
手法	しゅほう
放置	ほうち
信用	しんよう
最強	さいきょう
宮城	きゅうじょう|みやぎ
愛し	あいし|いとし
出産	しゅっさん
戦後	せんご
議会	ぎかい
競馬	けいば
命令	めいれい
単に	たんに
熱い	あつい|あちい
反省	はんせい
入札	にゅうさつ
清水	しみず|せいすい
伝える	つたえる
加入	かにゅう
受信	じゅしん
育児	いくじ
四季	しき
泣き	なき
上位	じょうい
倉庫	そうこ
交付	こうふ
受け付け	うけつけ
引き続き	ひきつづき
部隊	ぶたい
変動	へんどう
不良	ふりょう
人類	じんるい
最悪	さいあく
辞書	じしょ
苦笑	くしょう
不満	ふまん
日付	ひづけ
勇気	ゆうき
機種	きしゅ
給料	きゅうりょう
連中	れんちゅう|れんじゅう
未満	みまん
極めて	きわめて
対戦	たいせん
街道	かいどう
付ける	つける|づける
置く	おく
景気	けいき|げいき
有機	ゆうき
月末	つきずえ|げつまつ
発達	はったつ
県民	けんみん
軍事	ぐんじ
連休	れんきゅう
当選	とうせん
梅雨	つゆ|ばいう|づゆ
努め	つとめ
自治	じち
以後	いご
取り付け	とりつけ
果たして	はたして
辞典	じてん
付き合い	つきあい|づきあい
置き	おき
不正	ふせい
単なる	たんなる
連結	れんけつ
焼肉	やきにく
年末	ねんまつ
合成	ごうせい
望む	のぞむ
金利	きんり
相続	そうぞく
山梨	やまなし
冷たい	つめたい
区別	くべつ
単語	たんご
配達	はいたつ
知的	ちてき
仲良く	なかよく
順番	じゅんばん
改良	かいりょう
見積もり	みつもり
初回	しょかい
各国	かっこく
借金	しゃっきん
法案	ほうあん
良好	りょうこう
入浴	にゅうよく
関節	かんせつ
予選	よせん
初日	はつひ|はつび|しょにち
残さ	のこさ|ざんさ
原料	げんりょう
順位	じゅんい
司法	しほう
無線	むせん
愛する	あいする
氏名	しめい
照明	しょうめい
上司	じょうし
観点	かんてん
品種	ひんしゅ
天井	てんじょう|てんせい
関わる	かかわる
録音	ろくおん
参り	まいり
追求	ついきゅう
国産	こくさん
入試	にゅうし
議長	ぎちょう
試み	こころみ
世帯	せたい|しょたい|じょたい
特急	とっきゅう
米軍	べいぐん
お笑い	おわらい
飲料	いんりょう|のみりょう
課長	かちょう
給付	きゅうふ
法令	ほうれい
光景	こうけい
商標	しょうひょう
笑う	わらう|わろう
有無	うむ
教材	きょうざい
考察	こうさつ
落札	らくさつ
手続	てつづき
産地	さんち
付く	つく|づく
祝日	しゅくじつ
健全	けんぜん
一種	いっしゅ
達し	たっし
残す	のこす
冷静	れいせい
自覚	じかく
助成	じょせい
長官	ちょうかん
信者	しんじゃ
戦う	たたかう|たたこう
観客	かんきゃく
戦国	せんごく
業種	ぎょうしゅ
見積り	みつもり
飛ぶ	とぶ
大戦	たいせん
観戦	かんせん
景観	けいかん
松山	まつやま
重量	じゅうりょう
不幸	ふこう
天候	てんこう
持参	じさん
順調	じゅんちょう
外観	がいかん
理念	りねん
録画	ろくが
生成	せいせい
内側	うちがわ|ないそく
食料	しょくりょう
器具	きぐ
手順	てじゅん
五輪	ごりん
昨夜	さくや|ゆうべ
飛行	ひこう
変身	へんしん
送付	そうふ
教養	きょうよう
祝い	いわい|ほい
右側	みぎがわ|うそく
成人	せいじん
究極	きゅうきょく
飛ばし	とばし
地位	ちい
結成	けっせい
争い	あらそい|あらがい
兵器	へいき
持続	じぞく
結ぶ	むすぶ
養成	ようせい
合唱	がっしょう
芸人	げいにん
海軍	かいぐん
参院	さんいん
大陸	たいりく
調達	ちょうたつ
牧場	ぼくじょう|まきば
有利	ゆうり
特産	とくさん
手伝い	てつだい
左側	ひだりがわ|さそく
各社	かくしゃ
側面	そくめん
古典	こてん
公的	こうてき
工芸	こうげい
陸上	りくじょう
笑み	えみ
加速	かそく
給食	きゅうしょく
初代	しょだい
気候	きこう
選定	せんてい
最中	もなか|さいちゅう|さなか
飛び	とび
水産	すいさん
園芸	えんげい
浴衣	ゆかた
地帯	ちたい
協定	きょうてい
固め	かため|がため
司会	しかい
通貨	つうか
伝わる	つたわる
残業	ざんぎょう
熱心	ねっしん
標高	ひょうこう
観る	みる
未だ	いまだ|まだ
満開	まんかい
折れ	おれ
借りる	かりる
血管	けっかん
参戦	さんせん
調節	ちょうせつ
共感	きょうかん
貨物	かもつ|かぶつ
要する	ようする
分岐	ぶんき
選べる	えらべる
覚える	おぼえる
節約	せつやく
数量	すうりょう
果て	はて
指標	しひょう
隊長	たいちょう
小児	しょうに
客観	きゃっかん|かっかん
結合	けつごう
お好み焼き	おこのみやき
決議	けつぎ
浴場	よくじょう
選考	せんこう
各号	かくごう
漁業	ぎょぎょう
目覚め	めざめ
事典	じてん
果実	かじつ
関数	かんすう
変形	へんけい
例外	れいがい
民家	みんか
冷え	ひえ|つめてえ|つべてえ
果物	くだもの
加える	くわえる
協同	きょうどう
特有	とくゆう
木材	もくざい
小倉	おぐら
工法	こうほう
飛び出し	とびだし
分散	ぶんさん
学的	がくてき
民宿	みんしゅく
愛用	あいよう
加算	かさん
信じる	しんじる
必見	ひっけん
法的	ほうてき
関わり	かかわり
差し	さし|ざし
良し	よし
達人	たつじん
機体	きたい
例年	れいねん
合戦	かっせん|がっせん
夫人	ふじん|ぷじん
近辺	きんぺん
加熱	かねつ
例え	たとえ
軽量	けいりょう
連動	れんどう
戦場	せんじょう|いくさば
食器	しょっき
付加	ふか
順次	じゅんじ
動機	どうき
部位	ぶい
願う	ねがう|ねごう
積ん	つん|つもん
失業	しつぎょう
結び	むすび
外側	そとがわ
待機	たいき
上陸	じょうりく
群れ	むれ
案外	あんがい
見積	みつもり
改定	かいてい
海老	えび
望み	のぞみ
戦力	せんりょく
満点	まんてん
人参	にんじん
完結	かんけつ
泣く	なく
戦前	せんぜん
指輪	ゆびわ
一連	いちれん
始末	しまつ
特例	とくれい
夜景	やけい
機動	きどう
末期	まっき|まつご
不便	ふべん
連想	れんそう
共和	きょうわ
隊員	たいいん
味覚	みかく
選出	せんしゅつ
特化	とっか
主観	しゅかん
有害	ゆうがい
完売	かんばい
欠け	かけ
不法	ふほう
戸建て	こだて
戦車	せんしゃ
包丁	ほうちょう|ぼうちょう
連発	れんぱつ
北側	きたがわ
各自	かくじ
果たす	はたす
好調	こうちょう
人種	じんしゅ
味付け	あじつけ
司令	しれい
焼く	やく
発覚	はっかく
議案	ぎあん
陸軍	りくぐん
特色	とくしょく
愛犬	あいけん
昨今	さっこん
対照	たいしょう
人民	じんみん
伝達	でんたつ
日焼け	ひやけ
焼け	やけ
必然	ひつぜん
不当	ふとう
西側	にしがわ
失う	うしなう|うしのう|のう
特長	とくちょう
連日	れんじつ
省エネ	しょうえね
改め	あらため
軍隊	ぐんたい
種別	しゅべつ
参画	さんかく
右折	うせつ
笑える	わらえる
道徳	どうとく
小松	こまつ
一望	いちぼう
参入	さんにゅう
便り	たより|だより
子孫	しそん
失点	しってん
直径	ちょっけい
改札	かいさつ
祝福	しゅくふく
所要	しょよう
式典	しきてん
浅い	あさい
香水	こうすい
共産	きょうさん
治安	ちあん
戸建	こだて
商法	しょうほう
帰省	きせい
定例	ていれい
南側	みなみがわ
単身	たんしん
英数字	えいすうじ
上達	じょうたつ
友好	ゆうこう
初夏	しょか
左折	させつ
浴室	よくしつ
植民	しょくみん
極上	ごくじょう
部材	ぶざい
今季	こんき
民事	みんじ
欠点	けってん
農民	のうみん
時折	ときおり
良品	りょうひん
満たし	みたし
共生	きょうせい
受給	じゅきゅう
機材	きざい
望ましい	のぞましい
縄文	じょうもん
未定	みてい
満たす	みたす
日差し	ひざし
固有	こゆう
焼き鳥	やきとり
連勝	れんしょう
戦隊	せんたい
出願	しゅつがん
英文	えいぶん
観念	かんねん
題材	だいざい
省令	しょうれい
特選	とくせん
市街	しがい
不利	ふり
仲良し	なかよし
井戸	いど
不問	ふもん
待望	たいぼう
包み	つつみ|くるみ|ずつみ
軍人	ぐんじん
無理やり	むりやり
会席	かいせき
徒然	とぜん|つれづれ
失い	うしない|ない
日産	にっさん
勇者	ゆうしゃ
敗戦	はいせん
周知	しゅうち
時給	じきゅう
一昨日	おとつい|おととい
利便	りべん
東側	ひがしがわ
半径	はんけい
敗北	はいぼく
不調	ふちょう|ぶちょう
競売	きょうばい|けいばい|せりうり
置き場	おきば
発熱	はつねつ
文法	ぶんぽう
建立	こんりゅう
試作	しさく
無言	むごん
外貨	がいか
最短	さいたん
街中	まちなか
無理矢理	むりやり
信念	しんねん
漁港	ぎょこう
別名	べつめい|べつみょう
折り返し	おりかえし
無知	むち
少量	しょうりょう
建てる	たてる|だてる
お参り	おまいり
積み重ね	つみかさね
試食	ししょく
議決	ぎけつ
県産	けんさん
車種	しゃしゅ
初めまして	はじめまして
決戦	けっせん
付着	ふちゃく
夕飯	ゆうはん|ゆうめし
帯び	おび
熱中	ねっちゅう
山菜	さんさい
一帯	いったい
連帯	れんたい
周期	しゅうき
愛車	あいしゃ
愛好	あいこう
歯周	ししゅう
積み	つみ|づみ
単行	たんこう
気付く	きづく
説教	せっきょう
良心	りょうしん
好感	こうかん
名付け	なづけ
気付き	きづき
治る	なおる|おさまる
取付	とりつけ
文芸	ぶんげい
物産	ぶっさん
たこ焼き	たこやき
海底	かいてい
満員	まんいん
栄光	えいこう
好意	こうい
新卒	しんそつ
最小	さいしょう
結末	けつまつ
達する	たっする
低温	ていおん
生協	せいきょう
成形	せいけい
残高	ざんだか
念願	ねんがん
直結	ちょっけつ
点灯	てんとう
種目	しゅもく
成る	なる
松原	まつばら
苦戦	くせん
折角	せっかく
客席	きゃくせき
目録	もくろく
出典	しゅってん
量産	りょうさん
万博	ばんぱく
変数	へんすう
集約	しゅうやく
一昨年	おととし
管内	かんない
未知	みち
終戦	しゅうせん
種子	しゅし
利点	りてん
首位	しゅい
愛子	いとしご|まなご
給水	きゅうすい
無数	むすう|むしゅ
加害	かがい
教訓	きょうくん
希少	きしょう
戦時	せんじ
配管	はいかん
町民	ちょうみん
菜の花	なのはな
願望	がんぼう
同法	どうほう
法定	ほうてい
不動	ふどう
別表	べっぴょう
無くなる	なくなる
欠席	けっせき
折り	おり
挙げる	あげる
集積	しゅうせき
無用	むよう
花束	はなたば
続出	ぞくしゅつ
案の定	あんのじょう
最期	さいご
両側	りょうがわ|りょうそく
何卒	なにとぞ
議事	ぎじ
極力	きょくりょく
実例	じつれい
灯台	とうだい
法要	ほうよう
熱帯	ねったい
国旗	こっき
駅伝	えきでん
商材	しょうざい
建つ	たつ|だつ
協働	きょうどう
目印	めじるし
挙式	きょしき
相関	そうかん
実戦	じっせん
飛鳥	ひちょう
名産	めいさん
冬季	とうき
辞める	やめる
不信	ふしん
固い	かたい
栄え	さかえ|はえ|ばえ
最古	さいこ
改変	かいへん
初戦	しょせん
参道	さんどう
民法	みんぽう
交差	こうさ
単品	たんぴん
好物	こうぶつ
分別	ふんべつ|ぶんべつ
無人	むじん|むにん|ぶにん|ぶじん
単体	たんたい
飛ばす	とばす
照会	しょうかい
矢印	やじるし
菜園	さいえん
無茶	むちゃ
公約	こうやく
積雪	せきせつ
考案	こうあん
要約	ようやく
区民	くみん
消失	しょうしつ
養子	ようし
最長	さいちょう
一挙	いっきょ
街頭	がいとう
利息	りそく
市議	しぎ
努める	つとめる
満月	まんげつ
音量	おんりょう
察し	さっし
指令	しれい
老化	ろうか
協調	きょうちょう
景品	けいひん
司馬	しば
梅酒	うめしゅ
例会	れいかい
集結	しゅうけつ
治す	なおす
給油	きゅうゆ
清算	せいさん
夏季	かき
競合	きょうごう
多種	たしゅ
期末	きまつ
手札	てふだ|しゅさつ
組成	そせい
清流	せいりゅう
公害	こうがい
山城	やまじろ
共用	きょうよう
好む	このむ
不全	ふぜん
欠ける	かける
初級	しょきゅう
連立	れんりつ
家臣	かしん
着付け	きつけ
野望	やぼう
試練	しれん
極め	きわめ|きめ|ぎめ
戦線	せんせん
害虫	がいちゅう
満席	まんせき
付録	ふろく
海辺	うみべ|かいへん
最多	さいた
水辺	みずべ|すいへん
単発	たんぱつ
衣類	いるい
標本	ひょうほん
立案	りつあん
祭典	さいてん
最速	さいそく
議席	ぎせき
労組	ろうくみ|ろうそ
衣服	いふく
発芽	はつが
夕焼け	ゆうやけ
挙動	きょどう
学芸	がくげい
合法	ごうほう
月給	げっきゅう
的中	てきちゅう
漁船	ぎょせん
別館	べっかん
標的	ひょうてき
連敗	れんぱい
利子	りし
試写	ししゃ
課金	かきん
競走	きょうそう
不意	ふい
園児	えんじ
日付け	ひづけ
着陸	ちゃくりく
大佐	たいさ
産直	さんちょく
人的	じんてき
改名	かいめい
戦死	せんし
働きかけ	はたらきかけ
塩分	えんぶん
別人	べつじん
落選	らくせん
白菜	はくさい|しろな
強要	きょうよう
折りたたみ	おりたたみ
終結	しゅうけつ
高卒	こうそつ
水位	すいい
立法	りっぽう
老い	おい
電極	でんきょく
見極め	みきわめ
下位	かい
加筆	かひつ
灯り	ともり|あかり
便所	べんじょ
土器	どき|かわらけ
試乗	しじょう
事案	じあん
方位	ほうい
器用	きよう|ぎよう
愛着	あいちゃく|あいじゃく
好ましい	このましい
作法	さほう|さくほう
機内	きない
特約	とくやく
利害	りがい
発散	はっさん
水量	すいりょう
休養	きゅうよう
選別	せんべつ
成約	せいやく
計量	けいりょう
無休	むきゅう
大差	たいさ
電機	でんき
連打	れんだ
静止	せいし
着信	ちゃくしん
所管	しょかん
熱意	ねつい
必勝	ひっしょう
産学	さんがく
加わる	くわわる
初音	はつね
青梅	あおうめ
節目	ふしめ
原案	げんあん
老後	ろうご
争う	あらそう|あらがう|あらごう
散る	ちる
建材	けんざい
教官	きょうかん
改行	かいぎょう
焼き肉	やきにく
女児	じょじ
線香	せんこう
愛想	あいそ|あいそう
利回り	りまわり
石材	せきざい
散らし	ちらし
低音	ていおん
向こう側	むこうがわ
昼飯	ひるめし|ちゅうはん
祝う	いわう|いおう
照れ	てれ
給湯	きゅうとう
戦記	せんき
男児	だんじ
試料	しりょう
積み上げ	つみあげ
試算	しさん
安置	あんち
泣ける	なける
結集	けっしゅう
別物	べつもの
内陸	ないりく
続行	ぞっこう
試す	ためす
熱気	ねっき
議題	ぎだい
根底	こんてい
連行	れんこう
無名	むめい
有給	ゆうきゅう
同然	どうぜん
手芸	しゅげい
種族	しゅぞく
節分	せつぶん
通達	つうたつ
子連れ	こづれ
打席	だせき
差し入れ	さしいれ
最良	さいりょう
思案	しあん|じあん
伝票	でんぴょう
点差	てんさ
城主	じょうしゅ
単一	たんいつ
失調	しっちょう
光栄	こうえい
固体	こたい
教徒	きょうと
主席	しゅせき
労力	ろうりょく
赤旗	あかはた
要員	よういん
悪徳	あくとく
多岐	たき
産後	さんご
無力	むりょく
各駅	かくえき
社説	しゃせつ
変色	へんしょく
失望	しつぼう
歌唱	かしょう
念頭	ねんとう
分量	ぶんりょう
自給	じきゅう
極意	ごくい
差し出し	さしだし|さしいだし
各所	かくしょ
車輪	しゃりん
目覚まし	めざまし
浴びる	あびる
別れる	わかれる
産み	うみ
原付	げんつき
すき焼き	すきやき
参観	さんかん
唱える	となえる
衣料	いりょう
最上	さいじょう
初頭	しょとう
便器	べんき
競輪	けいりん
生き残り	いきのこり
部類	ぶるい
底辺	ていへん
心底	しんてい|しんそこ
赤松	あかまつ
大笑い	おおわらい
使徒	しと
前菜	ぜんさい
不二	ふじ
牧野	ぼくや
健やか	すこやか
無形	むけい
勝敗	しょうはい
景勝	けいしょう
改める	あらためる
原産	げんさん
外伝	がいでん
兵隊	へいたい
無印	むじるし
改悪	かいあく
伝送	でんそう
試行	しこう
多量	たりょう
建国	けんこく
完走	かんそう
覚まし	さまし|ざまし
法事	ほうじ
大卒	だいそつ
名残	なごり
不服	ふふく
極楽	ごくらく
定量	ていりょう
内祝い	うちいわい
量子	りょうし
街路	がいろ
号泣	ごうきゅう
借地	しゃくち
街角	まちかど
産物	さんぶつ
副業	ふくぎょう
養育	よういく
香料	こうりょう
無地	むじ
兆し	きざし
灯油	とうゆ
付け加え	つけくわえ
器官	きかん
便乗	びんじょう
包む	つつむ|くるむ
参列	さんれつ
共鳴	きょうめい
笑い声	わらいごえ
無念	ぶねん|むねん
競う	きそう|きおう
養う	やしなう|やしのう
英和	えいわ
信心	しんじん
未明	みめい
結界	けっかい
歩兵	ほへい|ふひょう
地産	ちさん
民話	みんわ
説く	とく
新選	しんせん
知覚	ちかく
入選	にゅうせん
民生	みんせい
食塩	しょくえん
養生	ようじょう
海兵	かいへい
文例	ぶんれい
折り紙	おりがみ
熱湯	ねっとう|あつゆ
用法	ようほう
取付け	とりつけ
酒類	しゅるい
望月	もちづき
県議	けんぎ
産科	さんか
信徒	しんと
積立	つみたて
願い事	ねがいごと
民放	みんぽう
本位	ほんい
争点	そうてん
周回	しゅうかい
土日祝	どにちしゅく
松竹	しょうちく
気功	きこう
漁協	ぎょきょう
群生	ぐんせい
愛読	あいどく
二輪	にりん
愛国	あいこく
産む	うむ
一変	いっぺん
長老	ちょうろう
後続	こうぞく
周遊	しゅうゆう
借家	しゃくや|しゃっか
借入	かりいれ
試飲	しいん
焼鳥	やきとり
伝道	でんどう
特大	とくだい
養老	ようろう
空軍	くうぐん
付け根	つけね
札所	ふだしょ
力量	りきりょう
月極	つきぎめ
試みる	こころみる
戦法	せんぽう
極東	きょくとう
開戦	かいせん
選曲	せんきょく
例える	たとえる
特記	とっき
福利	ふくり
塩焼き	しおやき
英数	えいすう
助産	じょさん
特訓	とっくん
観葉	かんよう
祝祭日	しゅくさいじつ
連ね	つらね
香ばしい	こうばしい
首輪	くびわ
飛来	ひらい
城内	じょうない
民芸	みんげい
反戦	はんせん
好き勝手	すきかって
店側	みせがわ
必読	ひつどく
電器	でんき
強固	きょうこ
冷戦	れいせん
配給	はいきゅう
別紙	べっし
放牧	ほうぼく
結束	けっそく|ゆいそく
働ける	はたらける
初歩	しょほ
梨花	りか
照合	しょうごう
好い	すい|いい|よい
春季	しゅんき
同好	どうこう
日清	にっしん
残暑	ざんしょ
一戦	いっせん
覚せい	かくせい
動的	どうてき
都城	とじょう
目覚める	めざめる
一節	いっせつ
消極	しょうきょく
電灯	でんとう
労使	ろうし
極める	きわめる|きめる
末日	まつじつ
生まれ変わり	うまれかわり
集大成	しゅうたいせい
台無し	だいなし
空席	くうせき
楽観	らっかん
記法	きほう
大関	おおぜき
道標	どうひょう|みちしるべ
特番	とくばん
終末	しゅうまつ
学位	がくい
議定	ぎじょう|ぎてい
照らす	てらす
申し付け	もうしつけ
特筆	とくひつ
成年	せいねん
兵力	へいりょく
流量	りゅうりょう
街づくり	まちづくり
白熱	はくねつ
要る	いる
固形	こけい
固まり	かたまり
愛らしい	あいらしい
覚める	さめる
塩化	えんか
伝言	でんごん
焼きたて	やきたて
白衣	はくい|びゃくい|びゃくえ
気付け	きづけ|きつけ
お札	おさつ|おふだ
水害	すいがい
塩味	しおあじ
用例	ようれい
位相	いそう
時差	じさ
愛す	あいす
指差し	ゆびさし
有望	ゆうぼう
連戦	れんせん
発令	はつれい
調印	ちょういん
治験	ちけん
都民	とみん
察知	さっち
農法	のうほう
未然	みぜん
置物	おきもの
要点	ようてん
極度	きょくど
愛しい	いとしい
欠く	かく
無茶苦茶	むちゃくちゃ
植え付け	うえつけ
悲観	ひかん
法学	ほうがく
分位	ぶんい
苦笑い	わらい|にがわらい
太夫	たゆう|だゆう
秋季	しゅうき
積む	つむ
府立	ふりつ
安静	あんせい
成り立ち	なりたち
日本的	にほんてき
魚類	ぎょるい
博し	はくし|ひろし
熱血	ねっけつ
治水	ちすい
号給	ごうきゅう
高熱	こうねつ
金城	きんじょう
公然	こうぜん
日課	にっか
満面	まんめん
焼き物	やきもの
少佐	しょうさ
焼失	しょうしつ
村民	そんみん
願書	がんしょ
鳥類	ちょうるい
求む	もとむ
単調	たんちょう
成し	なし
不毛	ふもう
梅雨入り	つゆいり
結びつき	むすびつき
月例	げつれい
各人	かくじん
湯治	とうじ
香る	かおる
芽生え	めばえ
飛車	ひしゃ|びしゃ
海戦	かいせん
流産	りゅうざん
連投	れんとう
同氏	どうし
産品	さんひん
欠落	けつらく
口径	こうけい
敗者	はいしゃ
建具	たてぐ
野良	のら
各位	かくい
祝賀	しゅくが
飛散	ひさん
固める	かためる
病変	びょうへん
不味い	まじい|まずい
功労	こうろう
外付け	そとづけ
城南	じょうなん
新芽	しんめ
初心	しょしん|うぶ
神官	しんかん
松葉	まつば
側近	そっきん
各部	かくぶ
友愛	ゆうあい
具材	ぐざい
包帯	ほうたい
例文	れいぶん
公司	こうし|こんす
所以	ゆえん
極まりない	きわまりない
うろ覚え	うろおぼえ
特注	とくちゅう
見栄え	みばえ
言い伝え	いいつたえ
差す	さす
寒冷	かんれい
大敗	たいはい
見覚え	みおぼえ
小便	しょうべん
無機	むき
欠品	けっぴん
受付け	うけつけ
改ざん	かいざん
産出	さんしゅつ
外周	がいしゅう
司祭	しさい
伝記	でんき
建前	たてまえ
物置	ものおき
内戦	ないせん
試着	しちゃく
残雪	ざんせつ
単元	たんげん
城下	じょうか
果肉	かにく
電信	でんしん
和英	わえい
業法	ぎょうほう
自伝	じでん
新法	しんぽう
同席	どうせき
刷新	さっしん
不運	ふうん
焼き上げ	やきあげ
積算	せきさん
連隊	れんたい
県連	けんれん
高低	こうてい|たかひく
冷える	ひえる
最早	もはや
立て続け	たてつづけ
送受信	そうじゅしん
年賀	ねんが
社労	しゃろう
大成	たいせい
発案	はつあん
冷水	ひやみず|れいすい
事変	じへん
完治	かんち
民意	みんい
安産	あんざん
代官	だいかん
清酒	せいしゅ
折れる	おれる
光熱	こうねつ
投信	とうしん
各店	かくてん
付帯	ふたい
伝来	でんらい
完食	かんしょく
年初	ねんしょ
印字	いんじ
極み	きわみ
静けさ	しずけさ
季語	きご
低速	ていそく
連なる	つらなる
不覚	ふかく
投機	とうき
約定	やくじょう
冷やす	ひやす
結社	けっしゃ
清らか	きよらか
利く	きく
落差	らくさ
同種	どうしゅ
覚書	おぼえがき
列挙	れっきょ
日照	にっしょう
清め	きよめ|すめ
祝い金	いわいきん
大漁	たいりょう
宮司	ぐうじ
戦える	たたかえる
お産	おさん
高官	こうかん
前置き	まえおき
石器	せっき
月別	つきべつ
類する	るいする
兆候	ちょうこう
牧草	ぼくそう
試用	しよう
円満	えんまん
極悪	ごくあく
無口	むくち
参上	さんじょう
群落	ぐんらく
散らす	ちらす
不順	ふじゅん
前兆	ぜんちょう
置き去り	おきさり|おきざり
来季	らいき
長続き	ながつづき
変人	へんじん
不向き	ふむき
好転	こうてん
未練	みれん
照り	てり|でり
加味	かみ
芸者	げいしゃ
府内	ふない
集成	しゅうせい
成虫	せいちゅう
表札	ひょうさつ
材木	ざいもく
漁村	ぎょそん
体積	たいせき
加水	かすい
積分	せきぶん
漁場	ぎょじょう|ぎょば|りょうば
入隊	にゅうたい
続投	ぞくとう
切り札	きりふだ
成り行き	なりゆき
心地良い	ここちよい
種まき	たねまき
同類	どうるい
新参	しんざん
熱唱	ねっしょう
無色	むしょく
送別	そうべつ
泣かせ	なかせ
変調	へんちょう
害する	がいする
察する	さっする
千種	ちぐさ
無実	むじつ
手伝う	てつだう|てつどう
品位	ひんい
残せる	のこせる
世辞	せじ
買い付け	かいつけ
次官	じかん
山積み	やまづみ
借り入れ	かりいれ
交信	こうしん
選りすぐり	よりすぐり|えりすぐり
小隊	しょうたい
前例	ぜんれい
家老	かろう|がろう
十億	じゅうおく
固まる	かたまる
小松菜	こまつな
置場	おきば
顔料	がんりょう
米兵	べいへい
博文	はくぶん
両氏	りょうし
完敗	かんぱい
官民	かんみん
関門	かんもん
配付	はいふ
無礼	ぶれい
新種	しんしゅ
初見	しょけん
川辺	かわべ
法相	ほうしょう|ほっそう
焼成	しょうせい
刷り	すり|ずり
平岡	ひらおか
軍部	ぐんぶ
一説	いっせつ
各県	かくけん|かっけん
犬種	けんしゅ
血清	けっせい
戦中	せんちゅう
三位	さんみ
どん底	どんぞこ
達者	たっしゃ|だっしゃ
量的	りょうてき
無残	むざん
各課	かくか
平城	ひらじろ
連作	れんさく
司書	ししょ
英字	えいじ
左利き	ひだりきき
交戦	こうせん
標語	ひょうご
球児	きゅうじ
不発	ふはつ
無害	むがい
古城	こじょう
好天	こうてん
成す	なす
満期	まんき
塩水	えんすい|しおみず
用量	ようりょう
特区	とっく
利根	りこん
朝ご飯	あさごはん
談笑	だんしょう
熱愛	ねつあい
法科	ほうか
特売	とくばい
中隊	ちゅうたい
不定	ふてい
塩田	えんでん
画材	がざい
別記	べっき
転機	てんき
借用	しゃくよう
良し悪し	よしあし
熱戦	ねっせん
焼ける	やける
氏神	うじがみ
各界	かくかい|かっかい
軍用	ぐんよう
然り	しかり
一夫	いっぷ
内包	ないほう
功徳	くどく|こうとく
見栄	みえ
連山	れんざん
満室	まんしつ
共栄	きょうえい
梅林	うめばやし|ばいりん
束ね	たばね|つかね
欠場	けつじょう
周波	しゅうは
変わり目	かわりめ
望める	のぞめる
満タン	まんたん
満天	まんてん
学説	がくせつ
番付	ばんづけ
無くす	なくす
望遠	ぼうえん
悲願	ひがん
行く末	ゆくすえ
飯店	はんてん
使節	しせつ
司る	つかさどる
一軍	いちぐん
米英	べいえい
失速	しっそく
小径	こみち|しょうけい
大輪	たいりん
以南	いなん
王位	おうい
不通	ふつう
大夫	たいふ|たゆう|だいぶ|だゆう
古参	こさん
島民	とうみん
入念	にゅうねん
市井	しせい
気管	きかん
宮参り	みやまいり
大群	たいぐん
国府	こくふ
天満	てんまん
言説	げんせつ
底力	そこぢから
英明	えいめい
健気	けなげ
末っ子	すえっこ
訓令	くんれい
産生	さんせい
英米	えいべい
好機	こうき
折る	おる
定説	ていせつ
最愛	さいあい
開票	かいひょう
末広	すえひろ
貝類	かいるい
月初め	つきはじめ
同省	どうしょう
束の間	つかのま
飛べる	とべる
初日の出	はつひので
失神	しっしん
電位	でんい
灯火	とうか|ともしび
印紙	いんし
失笑	しっしょう
無期	むき|むご
重機	じゅうき
器材	きざい
買付	かいつけ
米倉	こめぐら
名札	なふだ
一苦労	ひとくろう
街灯	がいとう
変り	かわり
軍国	ぐんこく
結実	けつじつ
積もり	つもり|づもり
然し	しかし
小節	こぶし|しょうせつ
結石	けっせき
図案	ずあん
以北	いほく
底面	ていめん
要所	ようしょ
松林	まつばやし
着席	ちゃくせき
標題	ひょうだい
たい焼き	たいやき
不変	ふへん
列伝	れつでん
海側	うみがわ
仲直り	なかなおり
土建	どけん
身辺	しんぺん
一念	いちねん
実機	じっき
首席	しゅせき
赤飯	せきはん
香味	こうみ
百景	ひゃっけい
薬害	やくがい
通関	つうかん
無心	むしん
説法	せっぽう
全焼	ぜんしょう
内輪	うちわ|ないりん
泣く泣く	なくなく
兵法	へいほう|ひょうほう|びょうほう
初等	しょとう
線量	せんりょう
県側	けんがわ
法話	ほうわ
観月	かんげつ
水菜	みずな
実録	じつろく
図録	ずろく
氏子	うじこ
変位	へんい
泣き声	なきごえ
不平	ふへい
奈落	ならく
号令	ごうれい
大隊	だいたい
大別	たいべつ
念入り	ねんいり
差し歯	さしば
折り合い	おりあい
利口	りこう
府民	ふみん
覚ます	さます
別売り	べつうり
青果	せいか
以て	もて
億万	おくまん
病的	びょうてき
祝辞	しゅくじ
朝飯	あさめし|あさはん
開成	かいせい
飛び入り	とびいり
農産	のうさん
左官	さかん|しゃかん
続落	ぞくらく
自愛	じあい
唱歌	しょうか|しょうが
産学官	さんがくかん
出兵	しゅっぺい
極小	きょくしょう|ごくしょう
語録	ごろく
対極	たいきょく
信ぴょう	しんぴょう
炭焼き	すみやき
変速	へんそく
本願	ほんがん
年産	ねんさん
養分	ようぶん
朝焼け	あさやけ
親類	しんるい
無法	むほう
急変	きゅうへん
陸地	りくち
好投	こうとう
雨量	うりょう
主管	しゅかん
全景	ぜんけい
沖合	おきあい
水軍	すいぐん
失明	しつめい
花芽	はなめ|かが
養い	やしない
卒園	そつえん
下側	したがわ
冷気	れいき
公民	こうみん
順当	じゅんとう
小梅	こうめ
清和	せいわ
旗本	はたもと
草案	そうあん
こちら側	こちらがわ
選書	せんしょ
人選	じんせん
特命	とくめい
要人	ようじん
街区	がいく
帳票	ちょうひょう
答案	とうあん
八景	はっけい
戦勝	せんしょう
争議	そうぎ
芸名	げいめい
別所	べっしょ
軍服	ぐんぷく
道民	どうみん
温浴	おんよく
時季	じき
信金	しんきん
輪切り	わぎり
極道	ごくどう
七輪	しちりん
お仕置き	おしおき
辞令	じれい
各局	かくきょく
群集	ぐんしゅう
温熱	おんねつ
未読	みどく
地底	ちてい
中佐	ちゅうさ
都議	とぎ
的外れ	まとはずれ
消灯	しょうとう
進軍	しんぐん
省力	しょうりき|しょうりょく
無量	むりょう
試薬	しやく
置ける	おける
水利	すいり
類語	るいご
力説	りきせつ
失言	しつげん
城北	じょうほく
課外	かがい
中卒	ちゅうそつ
標記	ひょうき
敗れる	やぶれる
競り	せり|ぜり
商戦	しょうせん
名城	めいじょう
司教	しきょう
社協	しゃきょう
病害虫	びょうがいちゅう
本戦	ほんせん
積み立て	つみたて
富む	とむ
花輪	はなわ
愛でる	めでる
後輪	こうりん
利上げ	りあげ
養父	ようふ
共働き	ともばたらき
化成	かせい
心残り	こころのこり
前輪	ぜんりん
各紙	かくし
羽衣	はごろも
滋養	じよう
昨秋	さくしゅう
競泳	きょうえい
金貨	きんか
松明	たいまつ
新約	しんやく
向かい側	むかいがわ
決別	けつべつ
花器	かき
課す	かす
底上げ	そこあげ
神器	じんぎ
地熱	じねつ|ちねつ
物好き	ものずき
高給	こうきゅう
全席	ぜんせき
機長	きちょう
女官	にょかん|じょかん
岩塩	がんえん
笑い話	わらいばなし
戦友	せんゆう
初雪	はつゆき
老年	ろうねん
焼き魚	やきざかな
同位	どうい
他愛	たあい
改選	かいせん
昨日今日	きのうきょう
散見	さんけん
湯量	ゆりょう
所望	しょもう
方便	ほうべん
法輪	ほうりん|ぼうりん
選対	せんたい
以西	いせい
低木	ていぼく
関所	せきしょ
省く	はぶく
満車	まんしゃ
大泣き	おおなき
静養	せいよう
極細	ごくぼそ
説話	せつわ
鹿角	ろっかく
大軍	たいぐん
軍配	ぐんばい
茶器	ちゃき
府県	ふけん
先達	せんだつ
軍手	ぐんて
香典	こうでん
無二	むに
浅見	せんけん
極太	ごくぶと
失念	しつねん
無病	むびょう
法王	ほうおう
不死	ふし
管区	かんく
国軍	こくぐん
育英	いくえい
単線	たんせん
街歩き	まちあるき
近付く	ちかづく
戦果	せんか
副題	ふくだい
大観	たいかん
議院	ぎいん
入管	にゅうかん
重臣	じゅうしん
原典	げんてん
初耳	はつみみ
共学	きょうがく
美的	びてき
長城	ちょうじょう
関係者	かんけいしゃ
具体的	ぐたいてき
管理者	かんりしゃ
管理人	かんりにん
利用者	りようしゃ
手数料	てすうりょう
参加者	さんかしゃ
初心者	しょしんしゃ
積極的	せっきょくてき
博物館	はくぶつかん
取引法	とりひきほう
労働者	ろうどうしゃ
協議会	きょうぎかい
飛行機	ひこうき
社会的	しゃかいてき
商店街	しょうてんがい
自治体	じちたい
自動的	じどうてき
時間帯	じかんたい
最終的	さいしゅうてき
交差点	こうさてん
説明会	せつめいかい
英会話	えいかいわ
観光客	かんこうきゃく
定期的	ていきてき
世界的	せかいてき
全体的	ぜんたいてき
最大級	さいだいきゅう
不具合	ふぐあい
記念日	きねんび
体験談	たいけんだん
一時的	いちじてき
市街地	しがいち
不安定	ふあんてい
卒業生	そつぎょうせい
代表的	だいひょうてき
最終日	さいしゅうび
小児科	しょうにか
観光地	かんこうち
科学的	かがくてき
受付中	うけつけちゅう
参議院	さんぎいん
結果的	けっかてき
満足度	まんぞくど
労働省	ろうどうしょう
単行本	たんこうぼん
会議室	かいぎしつ
副作用	ふくさよう
目的地	もくてきち
公民館	こうみんかん
客観的	きゃっかんてき
調味料	ちょうみりょう
原材料	げんざいりょう
海水浴	かいすいよく
受験生	じゅけんせい
生産者	せいさんしゃ
一方的	いっぽうてき
卒業後	そつぎょうご
全国的	ぜんこくてき
参院選	さんいんせん
市議会	しぎかい
百貨店	ひゃっかてん
希望者	きぼうしゃ
会議所	かいぎしょ
連合会	れんごうかい
特産品	とくさんひん
料理店	りょうりてん
周波数	しゅうはすう
説明書	せつめいしょ
根本的	こんぽんてき
世界観	せかいかん
日本軍	にほんぐん
今週末	こんしゅうまつ
大自然	だいしぜん
合理的	ごうりてき
記念館	きねんかん
共和国	きょうわこく
不自由	ふじゆう
無関係	むかんけい
大浴場	だいよくじょう
無意味	むいみ
不自然	ふしぜん
植民地	しょくみんち
農産物	のうさんぶつ
交通省	こうつうしょう
選挙区	せんきょく
不十分	ふじゅうぶん
卒業式	そつぎょうしき
決定的	けっていてき
科学省	かがくしょう
法改正	ほうかいせい
不動産屋	ふどうさんや
落札者	らくさつしゃ
未成年	みせいねん
要注意	ようちゅうい
物理的	ぶつりてき
画期的	かっきてき
機関車	きかんしゃ
使用料	しようりょう
理想的	りそうてき
不気味	ぶきみ
最前線	さいぜんせん
全面的	ぜんめんてき
時間的	じかんてき
意図的	いとてき
最高級	さいこうきゅう
助成金	じょせいきん
共同体	きょうどうたい
放課後	ほうかご
無農薬	むのうやく
長期的	ちょうきてき
歯周病	ししゅうびょう
主観的	しゅかんてき
消化器	しょうかき
副会長	ふくかいちょう
文化的	ぶんかてき
加害者	かがいしゃ
給付金	きゅうふきん
食料品	しょくりょうひん
完成度	かんせいど
自治会	じちかい
昨年度	さくねんど
小説家	しょうせつか
自主的	じしゅてき
記念品	きねんひん
不定期	ふていき
県議会	けんぎかい
共通点	きょうつうてん
体験者	たいけんしゃ
参考書	さんこうしょ
不景気	ふけいき
競争力	きょうそうりょく
健康的	けんこうてき
競馬場	けいばじょう
城下町	じょうかまち
主治医	しゅじい
不良品	ふりょうひん
多目的	たもくてき
不登校	ふとうこう
工芸品	こうげいひん
協力者	きょうりょくしゃ
本会議	ほんかいぎ
相対的	そうたいてき
飛行場	ひこうじょう
計画的	けいかくてき
未使用	みしよう
年度末	ねんどまつ
決勝戦	けっしょうせん
登録者	とうろくしゃ
生徒会	せいとかい
加工品	かこうひん
対照的	たいしょうてき
生産量	せいさんりょう
必然的	ひつぜんてき
当選者	とうせんしゃ
参考人	さんこうにん
部分的	ぶぶんてき
最上階	さいじょうかい
司令官	しれいかん
産業省	さんぎょうしょう
人間的	にんげんてき
最新作	さいしんさく
交付金	こうふきん
初対面	しょたいめん
心理的	しんりてき
料理人	りょうりにん
望遠鏡	ぼうえんきょう
不都合	ふつごう
定例会	ていれいかい
医学的	いがくてき
相続人	そうぞくにん
機械的	きかいてき
成人式	せいじんしき
料金表	りょうきんひょう
試写会	ししゃかい
不器用	ぶきよう
最下位	さいかい
大成功	だいせいこう
初体験	はつたいけん
不完全	ふかんぜん
料理屋	りょうりや
感動的	かんどうてき
住民票	じゅうみんひょう
先週末	せんしゅうまつ
配信中	はいしんちゅう
印刷用	いんさつよう
低学年	ていがくねん
昨年末	さくねんまつ
利用料	りようりょう
改正前	かいせいまえ
法学部	ほうがくぶ
仲間達	なかまたち
交通量	こうつうりょう
借入金	かりいれきん
配送料	はいそうりょう
好立地	こうりっち
散歩道	さんぽみち
古民家	こみんか
急成長	きゅうせいちょう
近代的	きんだいてき
愛好家	あいこうか
加入者	かにゅうしゃ
試合後	しあいご
助手席	じょしゅせき
無料化	むりょうか
労働力	ろうどうりょく
天然石	てんねんせき
不用品	ふようひん
仲間内	なかまうち
無関心	むかんしん
自然界	しぜんかい
計算機	けいさんき
肉体的	にくたいてき
司会者	しかいしゃ
新感覚	しんかんかく
会社法	かいしゃほう
実用的	じつようてき
説明文	せつめいぶん
新生児	しんせいじ
使用量	しようりょう
達成感	たっせいかん
印刷物	いんさつぶつ
熱帯魚	ねったいぎょ
主体的	しゅたいてき
自発的	じはつてき
不細工	ぶさいく
議事録	ぎじろく
満足感	まんぞくかん
作成者	さくせいしゃ
予算案	よさんあん
先住民	せんじゅうみん
差別化	さべつか
国民的	こくみんてき
料理長	りょうりちょう
議定書	ぎていしょ
無差別	むさべつ
大好物	だいこうぶつ
出席者	しゅっせきしゃ
実験的	じっけんてき
君達	きみたち
司令部	しれいぶ
本願寺	ほんがんじ
英語力	えいごりょく
指定席	していせき
運転席	うんてんせき
分岐点	ぶんきてん
児童館	じどうかん
消極的	しょうきょくてき
家庭的	かていてき
不必要	ふひつよう
主成分	しゅせいぶん
先着順	せんちゃくじゅん
朝食付	ちょうしょくつき
未入力	みにゅうりょく
海産物	かいさんぶつ
身体的	しんたいてき
最新号	さいしんごう
最終戦	さいしゅうせん
軽量化	けいりょうか
同好会	どうこうかい
対照表	たいしょうひょう
戦時中	せんじちゅう
愛国心	あいこくしん
最大手	さいおおて
一戸建	いっこだて
最重要	さいじゅうよう
不特定	ふとくてい
民主化	みんしゅか
開放的	かいほうてき
副社長	ふくしゃちょう
化学的	かがくてき
未登録	みとうろく
地理的	ちりてき
試験場	しけんじょう
中国産	ちゅうごくさん
人工的	じんこうてき
安定的	あんていてき
軍事力	ぐんじりょく
要予約	ようよやく
公式戦	こうしきせん
英単語	えいたんご
電話機	でんわき
悪天候	あくてんこう
試合前	しあいまえ
受給者	じゅきゅうしゃ
不信感	ふしんかん
失業者	しつぎょうしゃ
希望日	きぼうび
不公平	ふこうへい
発電機	はつでんき
連合軍	れんごうぐん
海兵隊	かいへいたい
自治区	じちく
自治法	じちほう
生理的	せいりてき
試合中	しあいちゅう
産業界	さんぎょうかい
要望書	ようぼうしょ
立体的	りったいてき
持続的	じぞくてき
加速度	かそくど
各方面	かくほうめん
受験者	じゅけんしゃ
軍事的	ぐんじてき
市長選	しちょうせん
古典的	こてんてき
雪景色	ゆきげしき
重点的	じゅうてんてき
力不足	ちからぶそく
運動量	うんどうりょう
無人島	むじんとう
副大臣	ふくだいじん
法人化	ほうじんか
信号機	しんごうき
近未来	きんみらい
先入観	せんにゅうかん
具体例	ぐたいれい
初年度	しょねんど
数種類	すうしゅるい
今月末	こんげつまつ
集中的	しゅうちゅうてき
土産物	みやげもの
初勝利	はつしょうり
実体験	じったいけん
高周波	こうしゅうは
静電気	せいでんき
人民元	じんみんげん
大辞典	だいじてん
変化球	へんかきゅう
未完成	みかんせい
好意的	こういてき
原産地	げんさんち
残業代	ざんぎょうだい
最年少	さいねんしょう
季節感	きせつかん
外交官	がいこうかん
直感的	ちょっかんてき
有機物	ゆうきぶつ
交流戦	こうりゅうせん
表面的	ひょうめんてき
心不全	しんふぜん
受信料	じゅしんりょう
便利屋	べんりや
自然体	しぜんたい
民主的	みんしゅてき
先進的	せんしんてき
飲料水	いんりょうすい
別世界	べっせかい
不参加	ふさんか
自由席	じゆうせき
短期的	たんきてき
最上級	さいじょうきゅう
学芸員	がくげいいん
実験室	じっけんしつ
管理局	かんりきょく
給湯器	きゅうとうき
流星群	りゅうせいぐん
人類学	じんるいがく
積立金	つみたてきん
初期化	しょきか
送別会	そうべつかい
不本意	ふほんい
水産業	すいさんぎょう
副都心	ふくとしん
地元民	じもとみん
打楽器	だがっき
有料化	ゆうりょうか
水産物	すいさんぶつ
案内人	あんないにん
新記録	しんきろく
小料理	こりょうり
静止画	せいしが
音楽的	おんがくてき
祝賀会	しゅくがかい
功労者	こうろうしゃ
形式的	けいしきてき
森林浴	しんりんよく
成功者	せいこうしゃ
国内産	こくないさん
受信機	じゅしんき
石材店	せきざいてん
文例集	ぶんれいしゅう
決議案	けつぎあん
受話器	じゅわき
料金所	りょうきんじょ
平和的	へいわてき
地下街	ちかがい
中心街	ちゅうしんがい
通話料	つうわりょう
体力的	たいりょくてき
衣料品	いりょうひん
業種別	ぎょうしゅべつ
副議長	ふくぎちょう
歌合戦	うたがっせん
茶飯事	さはんじ
例外的	れいがいてき
投票所	とうひょうじょ
送付先	そうふさき
差別的	さべつてき
見積書	みつもりしょ
反省会	はんせいかい
旅客機	りょかくき
道徳的	どうとくてき
消火器	しょうかき
機関紙	きかんし
合法的	ごうほうてき
試作品	しさくひん
通信社	つうしんしゃ
最終章	さいしゅうしょう
町議会	ちょうぎかい
薬事法	やくじほう
天然水	てんねんすい
人道的	じんどうてき
競走馬	きょうそうば
歌唱力	かしょうりょく
手料理	てりょうり
選挙戦	せんきょせん
道案内	みちあんない
二輪車	にりんしゃ
未発表	みはっぴょう
沖縄戦	おきなわせん
多角的	たかくてき
不平等	ふびょうどう
愛好者	あいこうしゃ
試運転	しうんてん
人気順	にんきじゅん
給料日	きゅうりょうび
出産後	しゅっさんご
固定化	こていか
機械化	きかいか
大道芸	だいどうげい
機動隊	きどうたい
投票日	とうひょうび
真空管	しんくうかん
多面的	ためんてき
日本兵	にほんへい
管理下	かんりか
選挙法	せんきょほう
不注意	ふちゅうい
地元産	じもとさん
月例会	げつれいかい
民芸品	みんげいひん
無気力	むきりょく
陸上部	りくじょうぶ
不人気	ふにんき
連続的	れんぞくてき
人生観	じんせいかん
寒冷地	かんれいち
成果物	せいかぶつ
事例集	じれいしゅう
後始末	あとしまつ
連合国	れんごうこく
消化管	しょうかかん
別料金	べつりょうきん
交通法	こうつうほう
時間差	じかんさ
不合理	ふごうり
見聞録	けんぶんろく
児童書	じどうしょ
利用客	りようきゃく
定量的	ていりょうてき
機動力	きどうりょく
楽観的	らっかんてき
原風景	げんふうけい
記録的	きろくてき
伝言板	でんごんばん
原住民	げんじゅうみん
原始的	げんしてき
会議場	かいぎじょう
有機的	ゆうきてき
赤信号	あかしんごう
会議録	かいぎろく