情報	じょうほう
表示	ひょうじ
可能	かのう
内容	ないよう
現在	げんざい
個人	こじん
質問	しつもん
女性	じょせい|にょしょう
対応	たいおう
画像	がぞう
物件	ぶっけん
状態	じょうたい
技術	ぎじゅつ
機能	きのう
評価	ひょうか
基本	きほん
調査	ちょうさ
価格	かかく
条件	じょうけん
設定	せってい
実際	じっさい
効果	こうか
報告	ほうこく
歴史	れきし
保険	ほけん
経験	けいけん
理解	りかい
対象	たいしょう
確か	たしか
営業	えいぎょう
結構	けっこう
過去	かこ
広告	こうこく
事件	じけん
程度	ていど
保護	ほご
経営	けいえい
資料	しりょう
規定	きてい
責任	せきにん
国際	こくさい
移動	いどう
製品	せいひん
制度	せいど
過ぎ	すぎ
指導	しどう
運営	うんえい
編集	へんしゅう
政治	せいじ
非常	ひじょう
総合	そうごう
業務	ぎょうむ
絶対	ぜったい
限り	かぎり
判断	はんだん
団体	だんたい
政府	せいふ
原因	げんいん
表現	ひょうげん
建築	けんちく
男性	だんせい
投資	とうし
意識	いしき
知識	ちしき
設置	せっち
能力	のうりょく
準備	じゅんび
組織	そしき
限定	げんてい
消費	しょうひ
精神	せいしん
直接	ちょくせつ
実現	じつげん
興味	きょうみ
事務	じむ
構造	こうぞう
主義	しゅぎ
規約	きやく
通常	つうじょう
解決	かいけつ
増え	ふえ
事故	じこ
基準	きじゅん
検査	けんさ
転職	てんしょく
整備	せいび
製造	せいぞう
採用	さいよう
建設	けんせつ
美容	びよう
解説	かいせつ
取得	しゅとく
感謝	かんしゃ
職員	しょくいん
現場	げんば|げんじょう
授業	じゅぎょう
設計	せっけい
素材	そざい
印象	いんしょう
久しぶり	ひさしぶり
出演	しゅつえん
行政	ぎょうせい
現実	げんじつ
新規	しんき
構成	こうせい
現代	げんだい
資格	しかく
在庫	ざいこ
禁止	きんし
出版	しゅっぱん
有効	ゆうこう
導入	どうにゅう
提案	ていあん
医師	いし|くすし
反応	はんのう
金額	きんがく
保証	ほしょう
設備	せつび
修正	しゅうせい
研修	けんしゅう
比べ	くらべ
可愛い	かわいい|かわい
制作	せいさく
世紀	せいき
基づく	もとづく
回復	かいふく
日常	にちじょう
想像	そうぞう
費用	ひよう
複数	ふくすう
講演	こうえん
新築	しんちく
再生	さいせい
平均	へいきん
適用	てきよう
提出	ていしゅつ
伝統	でんとう
確保	かくほ
豊か	ゆたか
防止	ぼうし
現状	げんじょう
素晴らしい	すばらしい
豊富	ほうふ
再び	ふたたび
主張	しゅちょう
事情	じじょう
教授	きょうじゅ
報道	ほうどう
資金	しきん
手術	しゅじゅつ
許可	きょか
本格	ほんかく
正確	せいかく
現地	げんち
無断	むだん
一応	いちおう
利益	りえき|りやく
証明	しょうめい
示し	しめし
体制	たいせい
戦略	せんりゃく
犯罪	はんざい
表情	ひょうじょう
制限	せいげん
最適	さいてき
確実	かくじつ
増加	ぞうか
停止	ていし|ちょうじ
合格	ごうかく
性格	せいかく
復活	ふっかつ
独自	どくじ
規制	きせい
大型	おおがた
予防	よぼう
講師	こうし|こうじ
集団	しゅうだん
製作	せいさく
任せ	まかせ
効率	こうりつ
教師	きょうし
条例	じょうれい
弁当	べんとう
独立	どくりつ
夫婦	ふうふ|めおと|みょうと
設立	せつりつ
要素	ようそ
実績	じっせき
航空	こうくう
資産	しさん
感情	かんじょう
得る	える|うる
接続	せつぞく
物質	ぶっしつ
修理	しゅうり|しゅり
品質	ひんしつ
示す	しめす
評判	ひょうばん
支持	しじ
芸術	げいじゅつ
快適	かいてき
寄せ	よせ
周囲	しゅうい
公演	こうえん
職場	しょくば
同士	どうし
田舎	いなか
喜び	よろこび
現れ	あらわれ
構築	こうちく
演出	えんしゅつ
何故	なぜ|なにゆえ
活性	かっせい
標準	ひょうじゅん
原則	げんそく
減少	げんしょう
神経	しんけい
移転	いてん
受賞	じゅしょう
測定	そくてい
職業	しょくぎょう
居る	いる|おる
経過	けいか
確定	かくてい
所属	しょぞく
基地	きち
災害	さいがい
大統領	だいとうりょう
適切	てきせつ
居酒屋	いざかや
規則	きそく
勢い	いきおい
武器	ぶき
貸し	かし|がし
適当	てきとう
現象	げんしょう
慣れ	なれ
得意	とくい
財産	ざいさん
保育	ほいく
輸入	ゆにゅう
個別	こべつ
支配	しはい
所得	しょとく|ところえ
態度	たいど
機構	きこう
財政	ざいせい
義務	ぎむ
出張	しゅっちょう
指示	しじ
性能	せいのう
記述	きじゅつ
資本	しほん
開設	かいせつ
殺し	ころし|ごろし
格安	かくやす
好評	こうひょう
競技	きょうぎ
雑貨	ざっか
強制	きょうせい
自殺	じさつ
金属	きんぞく
解消	かいしょう
支え	ささえ|つかえ|かえ
明確	めいかく
損害	そんがい
文句	もんく
個性	こせい
常識	じょうしき
保健	ほけん
日程	にってい
成績	せいせき
美術	びじゅつ
過程	かてい
期限	きげん
特性	とくせい
保管	ほかん
設け	もうけ
備え	そなえ|ぞなえ
素直	すなお
殺人	さつじん
事態	じたい
複雑	ふくざつ
職人	しょくにん
限界	げんかい
統合	とうごう
芸能	げいのう
形態	けいたい
支給	しきゅう
再度	さいど
実態	じったい
経由	けいゆ
配布	はいふ
統一	とういつ
取り寄せ	とりよせ
新幹線	しんかんせん
支部	しぶ
博士	はかせ|はくし
習慣	しゅうかん
面接	めんせつ
通過	つうか
通報	つうほう
厚生	こうせい
税金	ぜいきん
検証	けんしょう
独特	どくとく
燃料	ねんりょう
増える	ふえる
予測	よそく
判決	はんけつ
支店	してん
復帰	ふっき
総会	そうかい
布団	ふとん|ぶとん
確立	かくりつ
血液	けつえき
前提	ぜんてい
定義	ていぎ
講習	こうしゅう
講義	こうぎ
現金	げんきん
検定	けんてい
性質	せいしつ
衛生	えいせい
過ぎる	よぎる|すぎる
統計	とうけい
造り	つくり|づくり
査定	さてい
広報	こうほう
応用	おうよう
受講	じゅこう
演技	えんぎ
食堂	しょくどう|じきどう
仏教	ぶっきょう
入居	にゅうきょ
判定	はんてい
小型	こがた
観測	かんそく
在住	ざいじゅう
防衛	ぼうえい
要因	よういん
在日	ざいにち
総理	そうり
永遠	えいえん|とわ
再現	さいげん
救急	きゅうきゅう
再開	さいかい
現役	げんえき
出現	しゅつげん
移行	いこう
予報	よほう
総務	そうむ
申告	しんこく
素人	しろうと
確率	かくりつ
主婦	しゅふ
新型	しんがた
提示	ていじ
余計	よけい
格好	かっこう|かっこ
容易	たやす|ようい
無効	むこう
留学	りゅうがく
予告	よこく
改造	かいぞう
条約	じょうやく
消防	しょうぼう
防災	ぼうさい
保全	ほぜん
特許	とっきょ
輸送	ゆそう
犯人	はんにん
有限	ゆうげん
編成	へんせい
容量	ようりょう
形状	けいじょう
余り	あまり
防ぐ	ふせぐ
幹部	かんぶ
勢力	せいりょく
開示	かいじ
修行	しゅぎょう
解放	かいほう
分布	ぶんぷ
保有	ほゆう
業績	ぎょうせき
幹事	かんじ
不可	ふか
応え	こたえ|いらえ
正解	せいかい
適正	てきせい
帰属	きぞく
付属	ふぞく
正常	せいじょう
主演	しゅえん
解散	かいさん
招待	しょうたい
過ごす	すごす
本質	ほんしつ
速報	そくほう
分解	ぶんかい
水準	すいじゅん
比べる	くらべる
経費	けいひ
暴力	ぼうりょく
往復	おうふく
輸出	ゆしゅつ
許し	ゆるし
大勢	おおぜい|たいせい|たいぜい
判明	はんめい
財団	ざいだん
週刊	しゅうかん
増し	まし
圧力	あつりょく
意義	いぎ
任意	にんい
実質	じっしつ
河川	かせん
逆転	ぎゃくてん
見解	けんかい
法則	ほうそく
保守	ほしゅ
本件	ほんけん
複製	ふくせい
正義	せいぎ
張り	はり|ばり|ぱり
得点	とくてん
賛成	さんせい
単独	たんどく
容器	ようき
点検	てんけん
酸素	さんそ
火災	かさい
花粉	かふん
移植	いしょく
総額	そうがく
相性	あいしょう
工程	こうてい
告白	こくはく
個室	こしつ
謝罪	しゃざい
制服	せいふく
職種	しょくしゅ
貿易	ぼうえき
婦人	ふじん|ぷじん
飼育	しいく
重複	じゅうふく|ちょうふく
愛情	あいじょう
財布	さいふ
酸化	さんか
軽減	けいげん
書士	しょし
刊行	かんこう
務め	つとめ
構想	こうそう
才能	さいのう
居住	きょじゅう
意志	いし
現れる	あらわれる
現行	げんこう
件数	けんすう
支える	ささえる|つかえる
防犯	ぼうはん
検出	けんしゅつ
省略	しょうりゃく
職務	しょくむ
財務	ざいむ
解体	かいたい
確信	かくしん
体質	たいしつ
説得	せっとく
史上	しじょう
保持	ほじ
告知	こくち
新刊	しんかん
雑談	ざつだん
戦士	せんし
正規	せいき
墓地	ぼち
境内	けいだい
寄り	より
規格	きかく
損失	そんしつ
加減	かげん
属性	ぞくせい
新設	しんせつ
構え	かまえ|がまえ
精度	せいど
高額	こうがく
複合	ふくごう
類似	るいじ
守備	しゅび
人格	じんかく
寄付	きふ
制定	せいてい
実務	じつむ
課税	かぜい
殺す	ころす
不快	ふかい
情熱	じょうねつ
真似	まね
一条	いちじょう
改修	かいしゅう
計測	けいそく
要件	ようけん
衛星	えいせい
再建	さいけん|さいこん
境界	きょうかい|きょうがい|けいかい
解明	かいめい
比率	ひりつ
木造	もくぞう
兵士	へいし
技能	ぎのう
無限	むげん
原告	げんこく
情勢	じょうせい
絶望	ぜつぼう
殺害	さつがい|せつがい
格差	かくさ
学術	がくじゅつ
接種	せっしゅ
肥料	ひりょう
暴走	ぼうそう
独り言	ひとりごと
武士	ぶし|もののふ
生態	せいたい
支出	ししゅつ
眼鏡	めがね|がんきょう
年寄り	としより|どしより
基金	ききん
答弁	とうべん
予備	よび
証言	しょうげん
混雑	こんざつ
団地	だんち
接客	せっきゃく
提言	ていげん
習得	しゅうとく
変態	へんたい
属する	ぞくする|しょくする
清潔	せいけつ
混合	こんごう
賞味	しょうみ
迷い	まよい
自演	じえん
個体	こたい
決断	けつだん
政令	せいれい
市営	しえい
不可欠	ふかけつ
再会	さいかい
増やす	ふやす
夢中	むちゅう
貸切	かしきり
出資	しゅっし
確かめ	たしかめ
適応	てきおう
修復	しゅうふく
養護	ようご
常連	じょうれん
演説	えんぜつ
住居	じゅうきょ
限度	げんど
水素	すいそ
復興	ふっこう
気象	きしょう
高価	こうか|たか|だか
液体	えきたい
学歴	がくれき
感性	かんせい
典型	てんけい
貯金	ちょきん
大賞	たいしょう
限る	かぎる
球団	きゅうだん
眼科	がんか
共演	きょうえん
救い	すくい
夫妻	ふさい
破損	はそん
不能	ふのう
識別	しきべつ
民営	みんえい
飼い主	かいぬし
減る	へる
移住	いじゅう
車検	しゃけん
苦情	くじょう
酒造	しゅぞう
破産	はさん
喜ぶ	よろこぶ
工務	こうむ
備考	びこう
告げ	つげ
案件	あんけん
演習	えんしゅう
復旧	ふっきゅう
復元	ふくげん
効く	きく
仮面	かめん
性別	せいべつ
横断	おうだん
中断	ちゅうだん
接近	せっきん
的確	てきかく|てっかく
校舎	こうしゃ
課程	かてい
易い	やすい|やしい
祖父	そふ|おおじ|じい|じじ
要領	ようりょう
国境	こっきょう|くにざかい
演じる	えんじる
先祖	せんぞ
月額	げつがく
上限	じょうげん
資材	しざい
経路	けいろ
保つ	たもつ|もつ
救う	すくう
仮想	かそう
断熱	だんねつ
標識	ひょうしき
本編	ほんぺん
減らし	へらし
停車	ていしゃ
血圧	けつあつ
主導	しゅどう
絶賛	ぜっさん
常時	じょうじ
入賞	にゅうしょう
任務	にんむ
特価	とっか
接着	せっちゃく
志望	しぼう
月刊	げっかん
建造	けんぞう
解答	かいとう
同居	どうきょ
応答	おうとう
永久	えいきゅう|とわ
祖母	そぼ|おば|ばば
完備	かんび
守護	しゅご
全額	ぜんがく
主任	しゅにん
適合	てきごう
燃焼	ねんしょう
営利	えいり
切断	せつだん
検察	けんさつ
消毒	しょうどく
実在	じつざい
実証	じっしょう
名義	めいぎ
減らす	へらす
良質	りょうしつ
解約	かいやく
不在	ふざい
増大	ぞうだい
務める	つとめる
技法	ぎほう
銀河	ぎんが
経歴	けいれき
経理	けいり
無職	ぶしょく|むしょく
交際	こうさい
軍団	ぐんだん
志向	しこう
採取	さいしゅ
快速	かいそく
断念	だんねん
半額	はんがく
比例	ひれい|ぴれい
混ん	こん|まじん
風情	ふぜい
必殺	ひっさつ
紀行	きこう
続編	ぞくへん
適度	てきど
再発	さいはつ
飼い	かい|がい
賛同	さんどう
辞任	じにん
招き	まねき
暗殺	あんさつ
歴代	れきだい
上質	じょうしつ
社団	しゃだん
水質	すいしつ
独身	どくしん
規程	きてい
電圧	でんあつ
再編	さいへん
団子	だんご
救助	きゅうじょ
鳥居	とりい
戦術	せんじゅつ
安価	あんか
友情	ゆうじょう
絶品	ぜっぴん
労務	ろうむ
中毒	ちゅうどく
接する	せっする
余地	よち
根性	こんじょう
複写	ふくしゃ
日刊	にっかん
燃費	ねんぴ
準用	じゅんよう
統制	とうせい
責め	せめ|ぜめ
立ち寄り	たちより
動脈	どうみゃく
所在	しょざい
情けない	なさけない
間接	かんせつ
特製	とくせい
代謝	たいしゃ
絶景	ぜっけい
基調	きちょう
防水	ぼうすい
木製	もくせい
移民	いみん
構図	こうず
採点	さいてん
許す	ゆるす
急性	きゅうせい
定額	ていがく|じょうがく
雑記	ざっき
運輸	うんゆ
同条	どうじょう
教職員	きょうしょくいん
制約	せいやく
外資	がいし
本堂	ほんどう
航海	こうかい
経つ	たつ
保安	ほあん
公布	こうふ
弁護	べんご
短編	たんぺん
単価	たんか
有価	ゆうか
留意	りゅうい
炭素	たんそ
提起	ていき
低減	ていげん
税制	ぜいせい
油断	ゆだん
留め	とどめ|とめ|どめ
前述	ぜんじゅつ
解禁	かいきん
税務	ぜいむ
述べる	のべる
悪質	あくしつ
漁師	りょうし
炭酸	たんさん
先程	さきほど
酸味	さんみ|すみ
公益	こうえき
統治	とうち|とうじ
告発	こくはつ
先制	せんせい
許容	きょよう
現に	げんに
体型	たいけい
会費	かいひ
残留	ざんりゅう
肥満	ひまん
燃える	もえる
招く	まねく
順序	じゅんじょ
増す	ます
安易	あんい
新興	しんこう
絶好	ぜっこう
急増	きゅうぞう
同情	どうじょう
基板	きばん
改築	かいちく
造形	ぞうけい
迷う	まよう
導く	みちびく
雑草	ざっそう
任命	にんめい
本能	ほんのう
引っ張り	ひっぱり
暴行	ぼうこう
領土	りょうど
効能	こうのう
上演	じょうえん
仏像	ぶつぞう
増税	ぞうぜい
設ける	もうける
税率	ぜいりつ
書評	しょひょう
初版	しょはん
低迷	ていめい
快感	かいかん
自在	じざい
可決	かけつ
和解	わかい
元祖	がんそ
物価	ぶっか
告げる	つげる
破れ	やぶれ|われ|やれ
自衛	じえい
性的	せいてき
材質	ざいしつ
居心地	いごこち
貸し出し	かしだし
任期	にんき
精進	しょうじん
製薬	せいやく
応える	こたえる
編み	あみ
武力	ぶりょく
粉末	ふんまつ
構い	かまい
犯行	はんこう
因子	いんし
住職	じゅうしょく
増進	ぞうしん
移設	いせつ
構内	こうない
倍率	ばいりつ
明示	めいじ
厚い	あつい|あちい
賞品	しょうひん
減額	げんがく
素晴らし	すばらし
快晴	かいせい
張る	はる|ばる
判る	わかる
護衛	ごえい
効力	こうりょく
衛門	えもん|えもんの
余談	よだん
接待	せったい
音質	おんしつ
実情	じつじょう
総研	そうけん
人件	じんけん
過失	かしつ
救出	きゅうしゅつ
特設	とくせつ
定価	ていか
移り	うつり
発現	はつげん
気の毒	きのどく
画質	がしつ
保留	ほりゅう
断然	だんぜん
大喜び	おおよろこび
心得	こころえ|こころう
率いる	ひきいる
築地	ついじ|つきじ
独り	ひとり
飼料	しりょう|かいりょう
前条	ぜんじょう
解る	わかる
理性	りせい
解く	とく|ほどく
功績	こうせき
製法	せいほう
物資	ぶっし
可愛らしい	かわいらしい
証人	しょうにん
心境	しんきょう
賞金	しょうきん
史料	しりょう
仮定	かてい
原価	げんか
伝授	でんじゅ
均一	きんいつ
測量	そくりょう
転移	てんい
河口	かこう|かわぐち
香具師	やし
素子	そし
気圧	きあつ
余分	よぶん
夢見	ゆめみ
日報	にっぽう
在学	ざいがく
価額	かがく
河原	かわら|がわら
長編	ちょうへん
支社	ししゃ
織り	おり
力士	りきし
有志	ゆうし
市政	しせい
色素	しきそ
留守	るす
断面	だんめん
貸付	かしつけ
提唱	ていしょう
在る	ある
防ぎ	ふせぎ
団長	だんちょう
増強	ぞうきょう
質感	しつかん
事象	じしょう
判例	はんれい
告示	こくじ
興行	こうぎょう
仮説	かせつ
過言	かげん|かごん
駅舎	えきしゃ
鉱山	こうざん
現物	げんぶつ
断言	だんげん
態勢	たいせい
編入	へんにゅう
格別	かくべつ
税額	ぜいがく
税法	ぜいほう
心情	しんじょう
証書	しょうしょ
協賛	きょうさん
作製	さくせい
委任	いにん
厚労	こうろう
法務	ほうむ
万能	ばんのう|まんのう
復習	ふくしゅう
健在	けんざい
採集	さいしゅう
選任	せんにん
備える	そなえる
倍増	ばいぞう
元素	げんそ
仮名	かな|かめい|がな|けみょう
団結	だんけつ
増設	ぞうせつ
損益	そんえき
無能	むのう
貧しい	まずしい
行程	こうてい
起因	きいん
散布	さんぷ
精力	せいりょく
判別	はんべつ
均等	きんとう
減量	げんりょう
義理	ぎり
知能	ちのう
後編	こうへん
雑魚	ざこ|じゃこ
前編	ぜんぺん
武道	ぶどう
受容	じゅよう
航路	こうろ
観賞	かんしょう
開講	かいこう
点在	てんざい
教団	きょうだん
精算	せいさん
墓石	はかいし|ぼせき
定評	ていひょう
特技	とくぎ
故意	こい
念仏	ねんぶつ|ねぶつ
正統	せいとう
地質	ちしつ|じしつ
演歌	えんか
法規	ほうき
団員	だんいん
悪夢	あくむ
総長	そうちょう
同志	どうし
鉱物	こうぶつ
在来	ざいらい
資質	ししつ
応対	おうたい
一眼	ひとめ
術後	じゅつご
営む	いとなむ
相応	そうおう|ふさわし
実演	じつえん
無罪	むざい
軽快	けいかい
情景	じょうけい
宿舎	しゅくしゃ
慣れる	なれる
人妻	ひとづま
公務	こうむ
高圧	こうあつ
質量	しつりょう
快楽	かいらく|けらく
入団	にゅうだん
破り	やぶり|わり
貸出	かしだし
国防	こくぼう
素顔	すがお
率直	そっちょく
義母	ぎぼ
造成	ぞうせい
知性	ちせい
不備	ふび
多額	たがく
牧師	ぼくし
法制	ほうせい
因果	いんが
有益	ゆうえき
昼過ぎ	ひるすぎ
人質	ひとじち
囲ん	かこん|めぐん
最寄	もより
常任	じょうにん
接点	せってん
混ぜる	まぜる
効き	きき
役職	やくしょく
評議	ひょうぎ
版画	はんが
毛布	もうふ
現職	げんしょく
安保	あんぽ
技師	ぎし
貸家	かしや
大河	たいが
経年	けいねん
移る	うつる
対比	たいひ
編曲	へんきょく
支所	ししょ
停電	ていでん
保温	ほおん
時価	じか
朝刊	ちょうかん
混入	こんにゅう
公営	こうえい
接合	せつごう
減税	げんぜい
造る	つくる|づくる
理容	りよう
格子	こうし|ごうし
支度	したく|じたく
解き	とき|ほどき
間際	まぎわ
演算	えんざん
相応しい	ふさわしい
過度	かど
迷子	まいご
図解	ずかい
最寄り	もより
加護	かご
過ごせる	すごせる
採り	とり|どり
挙句	あげく
故人	こじん
常温	じょうおん
右衛門	えもん
差額	さがく
総数	そうすう
塩素	えんそ
導き	みちびき
白河	はくが
重厚	じゅうこう
夕刊	ゆうかん
参政	さんせい
救命	きゅうめい
在り	あり
絶大	ぜつだい
武家	ぶけ
運勢	うんせい
半減	はんげん
幹線	かんせん
配備	はいび
祖国	そこく
公示	こうじ
調停	ちょうてい
伝導	でんどう
移す	うつす
応急	おうきゅう
都営	とえい
山脈	さんみゃく
国政	こくせい
防火	ぼうか
静脈	じょうみゃく
貧血	ひんけつ
反則	はんそく
体勢	たいせい
備品	びひん
採算	さいさん
格付け	かくづけ
公団	こうだん
織物	おりもの
原型	げんけい
提灯	ちょうちん|ぢょうちん
体格	たいかく
人情	にんじょう
精製	せいせい
外務	がいむ
金型	かながた
可動	かどう
公判	こうはん
乗務	じょうむ
採決	さいけつ
一報	いっぽう
政界	せいかい
新婦	しんぷ
雑学	ざつがく
楽団	がくだん
任せる	まかせる
受領	じゅりょう|ずりょう
実技	じつぎ
時効	じこう
失格	しっかく
出費	しゅっぴ
寄り道	よりみち
大師	だいし
基点	きてん
読解	どっかい
悪性	あくせい|あくしょう
史実	しじつ
通告	つうこく
個数	こすう
断定	だんてい
運河	うんが
地検	ちけん
基幹	きかん
断る	ことわる
確かめる	たしかめる
防具	ぼうぐ
酸性	さんせい
冷え性	ひえしょう
墓参り	はかまいり
現われ	あらわれ
有罪	ゆうざい
精子	せいし
貸借	たいしゃく
配属	はいぞく
運航	うんこう
国営	こくえい
眼差し	まなざし
志願	しがん
減速	げんそく
暴言	ぼうげん
築く	きずく|つく|づく
毒性	どくせい
県境	けんきょう|けんざかい
検事	けんじ
辞職	じしょく
囲む	かこむ
圧勝	あっしょう
迷宮	めいきゅう
公告	こうこく
会報	かいほう
武術	ぶじゅつ
駅弁	えきべん
造船	ぞうせん
寄せる	よせる
労災	ろうさい
経常	けいじょう
気質	かたぎ|きしつ
総勢	そうぜい
大仏	だいぶつ
演目	えんもく
中略	ちゅうりゃく
師事	しじ
寄る	よる
極限	きょくげん
求職	きゅうしょく
寄生	きせい
損保	そんぽ
適性	てきせい
肥大	ひだい
増額	ぞうがく
独断	どくだん
引き寄せ	ひきよせ
地価	ちか
検知	けんち
前衛	ぜんえい
混同	こんどう
中性	ちゅうせい
絶版	ぜっぱん
常務	じょうむ
転居	てんきょ
人脈	じんみゃく
祖先	そせん
血統	けっとう
構える	かまえる
飼う	かう|こう
過ち	あやまち
解読	かいどく
永住	えいじゅう
条文	じょうぶん
混在	こんざい
直営	ちょくえい
修士	しゅうし
断り	ことわり
学費	がくひ
責務	せきむ
似合い	にあい
眼下	がんか
欠損	けっそん
謝る	あやまる
適量	てきりょう
報復	ほうふく
絵師	えし
得する	とくする
新居	しんきょ
包囲	ほうい
変容	へんよう
信条	しんじょう
暗示	あんじ
暴落	ぼうらく
文脈	ぶんみゃく
自費	じひ
居間	いま
資する	しする
武者	むしゃ
師団	しだん
往来	おうらい
応力	おうりょく
氷河	ひょうが
暴動	ぼうどう
中型	ちゅうがた
境地	きょうち
常設	じょうせつ
混じり	まじり
設営	せつえい
心構え	こころがまえ
開演	かいえん
件名	けんめい
関税	かんぜい
枝豆	えだまめ
保養	ほよう
実費	じっぴ
耕作	こうさく
陽性	ようせい
営み	いとなみ
戦犯	せんぱん
実効	じっこう
発刊	はっかん
修業	しゅぎょう|しゅうぎょう
反復	はんぷく
常用	じょうよう
フッ素	ふっそ
電解	でんかい
対価	たいか
貯まる	たまる
義父	ぎふ
破る	やぶる|わる
精米	せいまい
近接	きんせつ
教祖	きょうそ
河童	かっぱ
仮設	かせつ
賞賛	しょうさん
病状	びょうじょう
準ずる	じゅんずる
国益	こくえき
指圧	しあつ
増減	ぞうげん
罪悪	ざいあく
造園	ぞうえん
画素	がそ
移管	いかん
立証	りっしょう
角質	かくしつ
応じる	おうじる
薬師	くすし|やくし
取寄せ	とりよせ
業態	ぎょうたい
上告	じょうこく
移入	いにゅう
共益	きょうえき
制圧	せいあつ
支流	しりゅう
修得	しゅうとく
解任	かいにん
分断	ぶんだん
総体	そうたい
品格	ひんかく
県政	けんせい
適格	てきかく|てっかく
招集	しょうしゅう
交易	こうえき
容積	ようせき
航行	こうこう
有能	ゆうのう
国保	こくほ
寄席	よせ
気絶	きぜつ
愛護	あいご
支柱	しちゅう
受益	じゅえき
政務	せいむ
木綿	もめん|きわた|もくめん
総統	そうとう
月経	げっけい
語句	ごく
現像	げんぞう
病態	びょうたい
法師	ほうし|ほし|ぼうし|ぼし
防音	ぼうおん
支局	しきょく
効用	こうよう
分厚い	ぶあつい|ぶあちい
在留	ざいりゅう
減価	げんか
領主	りょうしゅ
後任	こうにん
平常	へいじょう
比重	ひじゅう
在職	ざいしょく
死因	しいん
精液	せいえき
増築	ぞうちく
余程	よほど
慣習	かんしゅう
花弁	かべん|はなびら
官能	かんのう
精通	せいつう
旅費	りょひ
防寒	ぼうかん
個所	かしょ
重賞	じゅうしょう
良識	りょうしき
女史	じょし
精油	せいゆ
競演	きょうえん
測る	はかる
変質	へんしつ
神仏	しんぶつ|かみほとけ
電報	でんぽう
過大	かだい
ろ過	ろか
炭鉱	たんこう
現世	げんせ|げんせい
築城	ちくじょう
夢見る	ゆめみる
殺虫	さっちゅう
先導	せんどう
根幹	こんかん
後述	こうじゅつ
格言	かくげん
祖父母	そふぼ
古河	ふるかわ
勝率	しょうりつ
雑感	ざっかん
過労	かろう
合弁	ごうべん
教義	きょうぎ
製本	せいほん
増資	ぞうし
布教	ふきょう
禁断	きんだん
断固	だんこ
本性	ほんしょう|ほんせい
不可解	ふかかい
近衛	このえ|こんえ
賛美	さんび
下限	かげん
税関	ぜいかん
復刊	ふっかん
留置	りゅうち|とめおき
一句	いっく
責める	せめる
演題	えんだい
貸す	かす|がす
銅像	どうぞう
講堂	こうどう
送検	そうけん
常備	じょうび
迷路	めいろ
防護	ぼうご
災い	わざわい
談義	だんぎ
財界	ざいかい
明快	めいかい
風格	ふうかく
金賞	きんしょう
貸金	かしきん
桜木	さくらぎ
迷走	めいそう
雑音	ざつおん
節句	せっく|ぜっく
初演	しょえん
独学	どくがく
反逆	はんぎゃく
桜花	おうか|さくらばな
殺意	さつい
製鉄	せいてつ
総じて	そうじて
眼前	がんぜん
全編	ぜんぺん
往生	おうじょう
新旧	しんきゅう
農政	のうせい
相殺	そうさい|そうさつ
素手	すで
農耕	のうこう
国税	こくぜい
士官	しかん
移送	いそう
険しい	けわしい
断絶	だんぜつ
快挙	かいきょ
人殺し	ひとごろし
新報	しんぽう
囲い	かこい|がこい
版元	はんもと
上述	じょうじゅつ
動態	どうたい
検挙	けんきょ
布告	ふこく
外構	がいこう
仏具	ぶつぐ
調製	ちょうせい
快勝	かいしょう
居室	きょしつ
職歴	しょくれき
類型	るいけい
打破	だは
国務	こくむ
見張り	みはり
修道	しゅうどう
素質	そしつ
旧道	きゅうどう
貯める	ためる
断食	だんじき
新版	しんばん|しんぱん
横領	おうりょう
鉱石	こうせき
一因	いちいん
能率	のうりつ
得票	とくひょう
犯す	おかす
貧弱	ひんじゃく
図版	ずはん
具現	ぐげん
利率	りりつ
出航	しゅっこう
物性	ぶっせい
増量	ぞうりょう
受精	じゅせい
率先	そっせん
仏法	ぶっぽう
手応え	てごたえ
性器	せいき
歴任	れきにん
役務	えきむ
義歯	ぎし
石仏	せきぶつ|いしぼとけ
領地	りょうち
情け	なさけ
士気	しき
行き過ぎ	いきすぎ|ゆきすぎ
技量	ぎりょう
手造り	てづくり
内政	ないせい
暴れる	あばれる
差し支え	さしつかえ
食費	しょくひ
天災	てんさい
教示	きょうじ|きょうし
総て	すべて
成仏	じょうぶつ
長居	ながい
手技	しゅぎ
羽織	はおり|ばおり
定型	ていけい
絶句	ぜっく
健常	けんじょう
輸血	ゆけつ
増水	ぞうすい
師走	しわす
防備	ぼうび
講じる	こうじる
成型	せいけい
素早い	すばやい
眼球	がんきゅう
永続	えいぞく
禁物	きんもつ
県営	けんえい
増改築	ぞうかいちく
米粉	こめこ|べいふん
買得	かいどく
豊作	ほうさく
接戦	せっせん
加圧	かあつ
同性	どうせい
判事	はんじ
適時	てきじ
非行	ひこう
再興	さいこう
中絶	ちゅうぜつ
許せる	ゆるせる
一堂	いちどう
快調	かいちょう
確変	かくへん
油圧	ゆあつ
手際	てぎわ
護岸	ごがん
報知	ほうち
内職	ないしょく
可変	かへん
音程	おんてい
張り紙	はりがみ
書留	かきとめ
燃やす	もやす
設問	せつもん
貸し切り	かしきり
水性	すいせい|みずしょう
大判	おおばん
逆さ	さかさ
謝礼	しゃれい
等価	とうか
移り変わり	うつりかわり
打率	だりつ
混む	こむ
毒素	どくそ
公職	こうしょく
大暴れ	おおあばれ
経典	きょうてん|けいてん
余る	あまる
型紙	かたがみ
変性	へんせい
真性	しんせい
測り	はかり
解ける	とける|ほどける
境目	さかいめ
ご利益	ごりやく
管制	かんせい
修験	しゅげん
休職	きゅうしょく
型式	かたしき|けいしき
永年	えいねん|ながねん
塩基	えんき
石綿	いしわた|せきめん
別格	べっかく
授賞	じゅしょう
質屋	しちや
増員	ぞういん
程よい	ほどよい
勢ぞろい	せいぞろい
混浴	こんよく
習性	しゅうせい
料率	りょうりつ
採血	さいけつ
別居	べっきょ
政局	せいきょく
軍師	ぐんし
用件	ようけん
肉厚	にくあつ
留保	りゅうほ
墓所	はかしょ|はかどころ|ぼしょ|むしょ
史観	しかん
増刊	ぞうかん
再三	さいさん
適法	てきほう
混ぜ合わせ	まぜあわせ
備長	びんちょう
辺境	へんきょう
報い	むくい
逆行	ぎゃっこう
演芸	えんげい
損なう	そこなう
移築	いちく
効き目	ききめ
形容	けいよう
必修	ひっしゅう
行財政	ぎょうざいせい
採る	とる|どる
生保	せいほ
囲み	かこみ
夢想	むそう
群像	ぐんぞう
流布	るふ
特質	とくしつ
講ずる	こうずる
現す	あらわす
余命	よめい
時限	じげん
肉眼	にくがん
往路	おうろ
興業	こうぎょう
知財	ちざい
経口	けいこう
程遠い	ほどとおい
故事	こじ
去勢	きょせい
営農	えいのう
年額	ねんがく
質素	しっそ
代弁	だいべん
再考	さいこう
精査	せいさ
節税	せつぜい
田舎者	いなかもの
軍勢	ぐんぜい
句集	くしゅう
英検	えいけん
見識	けんしき
遊技	ゆうぎ
暗証	あんしょう
評定	ひょうじょう|ひょうてい
照準	しょうじゅん
安保理	あんぽり
一過	いっか
公費	こうひ
構文	こうぶん
体現	たいげん
往年	おうねん
留まる	とどまる|とまる
夜桜	よざくら
喜ばしい	よろこばしい
見応え	みごたえ
墓場	はかば
講話	こうわ
罪人	ざいにん|つみびと
序章	じょしょう
永代	えいたい
備え付け	そなえつけ
逆流	ぎゃくりゅう
根絶	こんぜつ
旧約	きゅうやく
母性	ぼせい
教職	きょうしょく
志士	しし
告別	こくべつ
造営	ぞうえい
少額	しょうがく
不評	ふひょう
急務	きゅうむ
能楽	のうがく
国技	こくぎ
学資	がくし
市制	しせい
同額	どうがく
弁明	べんめい
非道	ひどう|ひど
居城	きょじょう
酒造り	さけづくり
増産	ぞうさん
型番	かたばん
慣らし	ならし
帰り際	かえりぎわ
総連	そうれん
破局	はきょく
在外	ざいがい
厚手	あつで
液状	えきじょう
面識	めんしき
破格	はかく
暴風	ぼうふう
家政	かせい
示談	じだん
久遠	くおん
雪解け	ゆきどけ
過多	かた
非情	ひじょう
慣行	かんこう
雑用	ざつよう|ぞうよう
子規	しき|ほととぎす
リン酸	りんさん
導電	どうでん
余白	よはく
本職	ほんしょく
鉱業	こうぎょう
熱演	ねつえん
近似	きんじ
妻子	さいし|つまこ
質的	しつてき
留年	りゅうねん
本領	ほんりょう
縄張り	なわばり
講和	こうわ
続報	ぞくほう
旅情	りょじょう
過熱	かねつ
可燃	かねん
再来	さいらい|さらい
殺し屋	ころしや
寄港	きこう
失態	しったい
増益	ぞうえき
職安	しょくあん
変則	へんそく
久しい	ひさしい
賛助	さんじょ
減点	げんてん
鉄則	てっそく
余力	よりょく
軍備	ぐんび
導師	どうし
正史	せいし
総武	そうぶ
再起	さいき
確約	かくやく
接地	せっち
木質	もくしつ
輸出入	ゆしゅつにゅう
土居	つちい|どい
武勇	ぶゆう
確証	かくしょう
素性	すじょう|そせい
復路	ふくろ
格付	かくづけ
防虫	ぼうちゅう
製材	せいざい
良型	りょうけい
広義	こうぎ
首領	しゅりょう
小枝	こえだ|さえだ
暴れん	あばれん
救護	きゅうご
民団	みんだん
素通り	すどおり
公設	こうせつ
寄進	きしん
任用	にんよう
領有	りょうゆう
好適	こうてき
貯水	ちょすい
製図	せいず
改編	かいへん
体液	たいえき
手製	てせい
定規	じょうぎ
球技	きゅうぎ
形質	けいしつ
町営	ちょうえい
船団	せんだん
整復	せいふく
旅団	りょだん
防げる	ふせげる
保冷	ほれい
検体	けんたい
内在	ないざい
可笑しい	おかしい
検品	けんぴん
複線	ふくせん
損する	そんする
戦績	せんせき
引率	いんそつ
平素	へいそ
読破	どくは
逆ギレ	ぎゃくぎれ
経産	けいさん
総代	そうだい
迷信	めいしん
態様	たいよう
横暴	おうぼう
布地	きれじ|ぬのじ
敗因	はいいん
共犯	きょうはん
青銅	せいどう
実測	じっそく
技工	ぎこう
殺そ	ころそ|さっそ
禁書	きんしょ
断続	だんぞく
雑種	ざっしゅ
弁理	べんり
護る	まもる
貸付け	かしつけ
石像	せきぞう
河岸	かがん|かし|かわぎし|がし
神職	しんしょく
修練	しゅうれん
挙げ句	あげく
旧型	きゅうがた
講談	こうだん
逆光	ぎゃっこう
逆らう	さからう
逆境	ぎゃっきょう
統率	とうそつ
造作	ぞうさ|ぞうさく
開祖	かいそ
学識	がくしき
荷造り	にづくり
護身	ごしん
旧来	きゅうらい
かき混ぜ	かきまぜ
史的	してき
着任	ちゃくにん
序曲	じょきょく
総量	そうりょう
余興	よきょう
制止	せいし
水圧	すいあつ
損金	そんきん
燃油	ねんゆ
旧制	きゅうせい
採れる	とれる
格式	かくしき|きゃくしき
主眼	しゅがん
殺生	せっしょう
社保	しゃほ
混迷	こんめい
不慣れ	ふなれ
略歴	りゃくれき
留める	とどめる|とめる
前職	ぜんしょく
市税	しぜい
小判	こばん
能動	のうどう
定率	ていりつ
気性	きしょう
寄せ植え	よせうえ
賞状	しょうじょう
志す	こころざす
山桜	やまざくら
無常	むじょう
織布	しょくふ
制する	せいする
全容	ぜんよう
同義	どうぎ
解毒	げどく
道程	どうてい|みちのり
査察	ささつ
主務	しゅむ
居候	いそうろう
政経	せいけい
薬効	やっこう
素晴しい	すばらしい
初任	しょにん
造語	ぞうご
有毒	ゆうどく
学士	がくし
失効	しっこう
人型	ひとがた
持久	じきゅう
紀要	きよう
息災	そくさい
電停	でんてい
休刊	きゅうかん
素足	すあし
老師	ろうし
余す	あます
肉質	にくしつ
殺気	さっき
格調	かくちょう
破たん	はたん
証し	しょうし|あかし
表象	ひょうしょう
しだれ桜	しだれざくら
雑多	ざった
得体	えたい
一団	いちだん
失禁	しっきん
管財	かんざい
例示	れいじ
講評	こうひょう
張り出し	はりだし
法政	ほうせい
公報	こうほう
仏事	ぶつじ
時報	じほう
税別	ぜいべつ
実像	じつぞう
慣用	かんよう
混血	こんけつ
飼養	しよう
比べ物	くらべもの
義兄	ぎけい
混じる	こんじる|まじる
居合	いあい
評点	ひょうてん
毒物	どくぶつ
総力	そうりょく
品性	ひんせい
損切り	そんぎり
序列	じょれつ
主幹	しゅかん
義姉	ぎし
逆手	ぎゃくて|さかて
費やす	ついやす
開眼	かいがん|かいげん
解法	かいほう
保身	ほしん
不可思議	ふかしぎ
苦境	くきょう
季刊	きかん
素案	そあん
不織	ふしょく
寄り付き	よりつき
不潔	ふけつ|やばち
暴挙	ぼうきょ
築造	ちくぞう
支線	しせん
真価	しんか
終演	しゅうえん
健保	けんぽ
平易	へいい
武具	ぶぐ
混戦	こんせん
製紙	せいし
絶する	ぜっする
過食	かしょく
往時	おうじ
塩酸	えんさん
順応	じゅんのう|じゅんおう
再選	さいせん
前略	ぜんりゃく
現われる	あらわれる
立像	りつぞう
前任	ぜんにん
名寄	なよせ
停戦	ていせん
再燃	さいねん
官報	かんぽう
新任	しんにん
温厚	おんこう
額面	がくめん
弁解	べんかい
発効	はっこう
書状	しょじょう
制動	せいどう
常緑	じょうりょく
近現代	きんげんだい
飼い犬	かいいぬ
紀元	きげん
絶え間	たえま
鉄製	てっせい|てつせい
規正	きせい
似非	えせ
布石	ふせき
証する	しょうする
読み応え	よみごたえ
師弟	してい
金堂	こんどう
製粉	せいふん
独走	どくそう
総社	そうじゃ
編み物	あみもの
買い得	かいどく
自賛	じさん
基底	きてい
きな粉	きなこ
人造	じんぞう
野性	やせい
政調	せいちょう
後衛	こうえい
写経	しゃきょう
再読	さいどく
木版	もくはん
貯留	ちょりゅう
食べ比べ	たべくらべ
救える	すくえる
教務	きょうむ
節減	せつげん
快気	かいき
原状	げんじょう
属国	ぞっこく
考証	こうしょう
利得	りとく
減圧	げんあつ
識者	しきしゃ
読経	どきょう|どっきょう
可能性	かのうせい
事務所	じむしょ
基本的	きほんてき
個人的	こじんてき
美術館	びじゅつかん
弁護士	べんごし
保育園	ほいくえん
消費者	しょうひしゃ
本格的	ほんかくてき
事務局	じむきょく
報告書	ほうこくしょ
公務員	こうむいん
活性化	かっせいか
政治家	せいじか
保護者	ほごしゃ
不可能	ふかのう
経営者	けいえいしゃ
効果的	こうかてき
消費税	しょうひぜい
文化財	ぶんかざい
講演会	こうえんかい
精神的	せいしんてき
芸能人	げいのうじん
経験者	けいけんしゃ
美容室	びようしつ
営業日	えいぎょうび
税理士	ぜいりし
歴史的	れきしてき
証明書	しょうめいしょ
保険料	ほけんりょう
未経験	みけいけん
所在地	しょざいち
技術者	ぎじゅつしゃ
投資家	とうしか
総合的	そうごうてき
必要性	ひつようせい
安全性	あんぜんせい
指導者	しどうしゃ
営業所	えいぎょうしょ
印象的	いんしょうてき
責任者	せきにんしゃ
編集部	へんしゅうぶ
政治的	せいじてき
不適切	ふてきせつ
可愛	かわい
伝統的	でんとうてき
出演者	しゅつえんしゃ
美容院	びよういん
製造業	せいぞうぎょう
講習会	こうしゅうかい
国際的	こくさいてき
効率的	こうりつてき
重要性	じゅうようせい
建築物	けんちくぶつ
方向性	ほうこうせい
工務店	こうむてん
最大限	さいだいげん
現時点	げんじてん
民営化	みんえいか
正確性	せいかくせい
現実的	げんじつてき
産婦人科	さんふじんか
技術的	ぎじゅつてき
保育所	ほいくしょ
留学生	りゅうがくせい
半導体	はんどうたい
幹事長	かんじちょう
資料館	しりょうかん
年賀状	ねんがじょう
無意識	むいしき
決定版	けっていばん
建築家	けんちくか
航空機	こうくうき
最低限	さいていげん
自家製	じかせい
非公開	ひこうかい
犯罪者	はんざいしゃ
精神科	せいしんか
高品質	こうひんしつ
予備校	よびこう
研修会	けんしゅうかい
新製品	しんせいひん
交通費	こうつうひ
個性的	こせいてき
対象外	たいしょうがい
主義者	しゅぎしゃ
業務用	ぎょうむよう
最寄駅	もよりえき
典型的	てんけいてき
低価格	ていかかく
実質的	じっしつてき
保険者	ほけんしゃ
対象者	たいしょうしゃ
説得力	せっとくりょく
編集者	へんしゅうしゃ
編集長	へんしゅうちょう
暴力団	ぼうりょくだん
会計士	かいけいし
高血圧	こうけつあつ
救急車	きゅうきゅうしゃ
総選挙	そうせんきょ
高性能	こうせいのう
多様性	たようせい
高画質	こうがしつ
質問者	しつもんしゃ
利便性	りべんせい
効率化	こうりつか
小麦粉	こむぎこ
日常的	にちじょうてき
人件費	じんけんひ
支持率	しじりつ
管理費	かんりひ
非表示	ひひょうじ
入居者	にゅうきょしゃ
有意義	ゆういぎ
非営利	ひえいり
機能性	きのうせい
保証金	ほしょうきん
無責任	むせきにん
方程式	ほうていしき
準決勝	じゅんけっしょう
管理職	かんりしょく
最小限	さいしょうげん
医師会	いしかい
血液型	けつえきがた
居場所	いばしょ
建造物	けんぞうぶつ
生産性	せいさんせい
不利益	ふりえき
絶対的	ぜったいてき
再開発	さいかいはつ
再利用	さいりよう
芸能界	げいのうかい
人間性	にんげんせい
強制的	きょうせいてき
基本法	きほんほう
建設業	けんせつぎょう
保健所	ほけんじょ
建築士	けんちくし
所得税	しょとくぜい
安定性	あんていせい
最適化	さいてきか
想像力	そうぞうりょく
習慣病	しゅうかんびょう
本質的	ほんしつてき
戦略的	せんりゃくてき
直接的	ちょくせつてき
競技場	きょうぎじょう
合格者	ごうかくしゃ
技術力	ぎじゅつりょく
基準法	きじゅんほう
解像度	かいぞうど
限定版	げんていばん
情報量	じょうほうりょう
栄養素	えいようそ
栄養士	えいようし
保証人	ほしょうにん
保険金	ほけんきん
留守番	るすばん
個人差	こじんさ
参加費	さんかひ
準備中	じゅんびちゅう
指導員	しどういん
出版物	しゅっぱんぶつ
芸術家	げいじゅつか
保育士	ほいくし
日本製	にほんせい
美容師	びようし
構造物	こうぞうぶつ
過半数	かはんすう
高機能	こうきのう
情報化	じょうほうか
全国版	ぜんこくばん
法人税	ほうじんぜい
製作所	せいさくしょ|せいさくじょ
申告書	しんこくしょ
番外編	ばんがいへん
絶好調	ぜっこうちょう
有効性	ゆうこうせい
合唱団	がっしょうだん
基地外	きちがい
婦人科	ふじんか
予約制	よやくせい
授業料	じゅぎょうりょう
体験版	たいけんばん
非常識	ひじょうしき
関連性	かんれんせい
消防団	しょうぼうだん
価格帯	かかくたい
不快感	ふかいかん
機能的	きのうてき
受賞者	じゅしょうしゃ
資本金	しほんきん
限度額	げんどがく
情報局	じょうほうきょく
世界史	せかいし
無条件	むじょうけん
生活費	せいかつひ
助教授	じょきょうじゅ
似顔絵	にがおえ
在学中	ざいがくちゅう
停留所	ていりゅうじょ
標準的	ひょうじゅんてき
世紀末	せいきまつ
事業費	じぎょうひ
常識的	じょうしきてき
表現力	ひょうげんりょく
支持者	しじしゃ
構成員	こうせいいん
支部長	しぶちょう
再起動	さいきどう
感情的	かんじょうてき
相続税	そうぞくぜい
内容量	ないようりょう
現在地	げんざいち
神経質	しんけいしつ
組織的	そしきてき
労務士	ろうむし
乗務員	じょうむいん
有用性	ゆうようせい
標準化	ひょうじゅんか
保険証	ほけんしょう
出張所	しゅっちょうじょ
受講者	じゅこうしゃ
未対応	みたいおう
関西弁	かんさいべん
調査会	ちょうさかい
非正規	ひせいき
移動中	いどうちゅう
精力的	せいりょくてき
紀元前	きげんぜん
共益費	きょうえきひ
新技術	しんぎじゅつ
衛生士	えいせいし
能力者	のうりょくしゃ
市職員	ししょくいん
国際化	こくさいか
報告会	ほうこくかい
所得者	しょとくしゃ
女性用	じょせいよう
資格者	しかくしゃ
会員制	かいいんせい
絶望的	ぜつぼうてき
精神病	せいしんびょう
適正化	てきせいか
付属品	ふぞくひん
相当額	そうとうがく
有識者	ゆうしきしゃ
本格化	ほんかくか
平均的	へいきんてき
住民税	じゅうみんぜい
研修医	けんしゅうい
感受性	かんじゅせい
再発見	さいはっけん
短編集	たんぺんしゅう
新世紀	しんせいき
罪悪感	ざいあくかん
寄生虫	きせいちゅう
保険法	ほけんほう
年会費	ねんかいひ
美術品	びじゅつひん
同性愛	どうせいあい
多機能	たきのう
招待状	しょうたいじょう
消費量	しょうひりょう
検察官	けんさつかん
支配人	しはいにん
意識的	いしきてき
関係性	かんけいせい
現行犯	げんこうはん
武道館	ぶどうかん
自衛官	じえいかん
救世主	きゅうせいしゅ
予告編	よこくへん
経歴書	けいれきしょ
無防備	むぼうび
合計額	ごうけいがく
雑貨屋	ざっかや
正常化	せいじょうか
酸化物	さんかぶつ
修道院	しゅうどういん
自給率	じきゅうりつ
研究費	けんきゅうひ
製作者	せいさくしゃ
研修生	けんしゅうせい
不規則	ふきそく
居住者	きょじゅうしゃ
雑木林	ぞうきばやし
精神力	せいしんりょく
無表情	むひょうじょう
不合格	ふごうかく
気管支	きかんし
何個	なんこ
整合性	せいごうせい
非日常	ひにちじょう
守護神	しゅごしん
無制限	むせいげん
構造的	こうぞうてき
助産師	じょさんし
工事費	こうじひ
事業団	じぎょうだん
責任感	せきにんかん
低所得	ていしょとく
業務上	ぎょうむじょう
現代的	げんだいてき
非課税	ひかぜい
総集編	そうしゅうへん
全体像	ぜんたいぞう
支配者	しはいしゃ
運転士	うんてんし
低気圧	ていきあつ
自営業	じえいぎょう
義務者	ぎむしゃ
評議員	ひょうぎいん
注意報	ちゅういほう
通気性	つうきせい
成長率	せいちょうりつ
断熱材	だんねつざい
現金化	げんきんか
社労士	しゃろうし
代議士	だいぎし
知識人	ちしきじん
史上初	しじょうはつ
防止法	ぼうしほう
飛行士	ひこうし
雑記帳	ざっきちょう
明確化	めいかくか
制作者	せいさくしゃ
武士道	ぶしどう
寄付金	きふきん
停止中	ていしちゅう
志望校	しぼうこう
中国製	ちゅうごくせい
受容体	じゅようたい
失業率	しつぎょうりつ
流動性	りゅうどうせい
正当性	せいとうせい
逆効果	ぎゃくこうか
国際法	こくさいほう
弁護人	べんごにん
保健室	ほけんしつ
判断力	はんだんりょく
新機能	しんきのう
保留中	ほりゅうちゅう
演出家	えんしゅつか
複数人	ふくすうにん
不整脈	ふせいみゃく
無所属	むしょぞく
解決法	かいけつほう
組織化	そしきか
暴走族	ぼうそうぞく
金属製	きんぞくせい
求職者	きゅうしょくしゃ
刊行物	かんこうぶつ
人物像	じんぶつぞう
植物性	しょくぶつせい
支店長	してんちょう
社会性	しゃかいせい
調教師	ちょうきょうし
支配下	しはいか
感謝祭	かんしゃさい
新人賞	しんじんしょう
芸術的	げいじゅつてき
不条理	ふじょうり
光熱費	こうねつひ
製品名	せいひんめい
効果音	こうかおん
受講料	じゅこうりょう
在校生	ざいこうせい
弁当箱	べんとうばこ
再発行	さいはっこう
留意点	りゅういてん
国際線	こくさいせん
再評価	さいひょうか
財務相	ざいむしょう
在来線	ざいらいせん
合理性	ごうりせい
非公式	ひこうしき
好印象	こういんしょう
設計図	せっけいず
製品化	せいひんか
暴力的	ぼうりょくてき
具現化	ぐげんか
製造元	せいぞうもと
禁止法	きんしほう
対象物	たいしょうぶつ
実用性	じつようせい
直営店	ちょくえいてん
停車駅	ていしゃえき
競技会	きょうぎかい
評議会	ひょうぎかい
標準語	ひょうじゅんご
法務局	ほうむきょく
解説書	かいせつしょ
事務員	じむいん
性犯罪	せいはんざい
測定器	そくていき
芸術祭	げいじゅつさい
栄養価	えいようか
利益率	りえきりつ
読解力	どっかいりょく
許可証	きょかしょう
文学賞	ぶんがくしょう
特別賞	とくべつしょう
保証書	ほしょうしょ
営業部	えいぎょうぶ
正義感	せいぎかん
仮想化	かそうか
記者団	きしゃだん
複合機	ふくごうき
教育費	きょういくひ
消防車	しょうぼうしゃ
統計的	とうけいてき
解説者	かいせつしゃ
備長炭	びんちょうたん
告別式	こくべつしき
保守的	ほしゅてき
少年団	しょうねんだん
予備軍	よびぐん
同一性	どういつせい
合格率	ごうかくりつ
感謝状	かんしゃじょう
投票率	とうひょうりつ
義務化	ぎむか
無造作	むぞうさ
大前提	だいぜんてい
受益者	じゅえきしゃ
美意識	びいしき
事務室	じむしつ
成功率	せいこうりつ
建設的	けんせつてき
市民税	しみんぜい
新興国	しんこうこく
弁護団	べんごだん
保健師	ほけんし
資料室	しりょうしつ
主任者	しゅにんしゃ
基地局	きちきょく
調理師	ちょうりし
大動脈	だいどうみゃく
必然性	ひつぜんせい
高学歴	こうがくれき
職員室	しょくいんしつ
容積率	ようせきりつ
調査員	ちょうさいん
衛生的	えいせいてき
演技力	えんぎりょく
原則的	げんそくてき
面接官	めんせつかん
限定的	げんていてき
輸入車	ゆにゅうしゃ
資料集	しりょうしゅう
小型化	こがたか
不適当	ふてきとう
道州制	どうしゅうせい
事故死	じこし
高評価	こうひょうか
自意識	じいしき
調査士	ちょうさし
健常者	けんじょうしゃ
集団的	しゅうだんてき
総務部	そうむぶ
弁理士	べんりし
低所得者	ていしょとくしゃ
物質的	ぶっしつてき
予防法	よぼうほう
営業中	えいぎょうちゅう
総務課	そうむか
氷河期	ひょうがき
中性子	ちゅうせいし
独自性	どくじせい
準備金	じゅんびきん
登録制	とうろくせい
情熱的	じょうねつてき
現代語	げんだいご
一体型	いったいがた
委任状	いにんじょう
婦人服	ふじんふく
統計学	とうけいがく
表示順	ひょうじじゅん
高気圧	こうきあつ
確信犯	かくしんはん
指導力	しどうりょく
総本山	そうほんざん
地方税	ちほうぜい
自主性	じしゅせい
団体戦	だんたいせん
先天性	せんてんせい
血液中	けつえきちゅう
確実性	かくじつせい
無機質	むきしつ
無限大	むげんだい
志願者	しがんしゃ
代表格	だいひょうかく
経営学	けいえいがく
営業職	えいぎょうしょく
日程表	にっていひょう
輸入品	ゆにゅうひん
得意先	とくいさき
直輸入	ちょくゆにゅう
外断熱	そとだんねつ
学術的	がくじゅつてき
高得点	こうとくてん
現実味	げんじつみ
主体性	しゅたいせい
公会堂	こうかいどう
居住地	きょじゅうち
再出発	さいしゅっぱつ
居住用	きょじゅうよう
歴史学	れきしがく
性教育	せいきょういく
得意技	とくいわざ
実効性	じっこうせい
最新刊	さいしんかん
貸付金	かしつけきん
個人名	こじんめい
張本人	ちょうほんにん
現代史	げんだいし
養育費	よういくひ
政治学	せいじがく
非売品	ひばいひん
混合物	こんごうぶつ
大航海	だいこうかい
公共性	こうきょうせい
議事堂	ぎじどう
快適性	かいてきせい
評価書	ひょうかしょ
無効化	むこうか
非線形	ひせんけい
断続的	だんぞくてき
小型犬	こがたけん
過労死	かろうし
事故車	じこしゃ
定時制	ていじせい
無期限	むきげん
総動員	そうどういん
高水準	こうすいじゅん
保育料	ほいくりょう
大本営	だいほんえい
動物性	どうぶつせい
競技者	きょうぎしゃ
気象台	きしょうだい
低学歴	ていがくれき
前日比	ぜんじつひ
再生産	さいせいさん
調査団	ちょうさだん