地域	ちいき
確認	かくにん
一覧	いちらん
子供	こども
探す	さがす
映画	えいが
提供	ていきょう
温泉	おんせん|いでゆ
探し	さがし
簡単	かんたん
存在	そんざい
住宅	じゅうたく
賃貸	ちんたい
経済	けいざい
専門	せんもん
忘れ	わすれれ|わすれ
対策	たいさく
欲しい	ほしい
ご覧	ごらん
届け	とどけ
担当	たんとう
障害	しょうがい
検討	けんとう
頂き	いただき
展開	てんかい
処理	しょり
自己	じこ
誕生	たんじょう
難しい	むずかしい|むつかしい
以降	いこう
法律	ほうりつ
著作	ちょさく
雑誌	ざっし
拡大	かくだい
認め	みとめ|したため
保存	ほぞん
暮らし	くらし|ぐらし
展示	てんじ
価値	かち
映像	えいぞう
負担	ふたん
改善	かいぜん
素敵	すてき
講座	こうざ
郵便	ゆうびん
危険	きけん
専用	せんよう
演奏	えんそう
政策	せいさく
若い	わかい
推進	すいしん
訪問	ほうもん
方針	ほうしん
看護	かんご
認識	にんしき
優勝	ゆうしょう
警察	けいさつ
異なる	ことなる
将来	しょうらい
規模	きぼ
装置	そうち
宇宙	うちゅう
批判	ひはん
自宅	じたく
議論	ぎろん
就職	しゅうしょく
政権	せいけん
発展	はってん
お腹	おなか
勤務	きんむ
疑問	ぎもん
段階	だんかい
改革	かいかく
納得	なっとく
値段	ねだん
操作	そうさ
認定	にんてい
厳しい	きびしい|いかめしい
異常	いじょう
処分	しょぶん
株式	かぶしき
申し訳	もうしわけ
著者	ちょしゃ
宗教	しゅうきょう
役割	やくわり
感染	かんせん
権利	けんり
候補	こうほ
済み	すみ|ずみ
呼ばれ	よばれ
降り	おり|ふり|くだり|ぶり
補助	ほじょ
収録	しゅうろく
除く	のぞく
死亡	しぼう
模様	もよう
訪れ	おとずれ
承認	しょうにん
秘密	ひみつ
容疑	ようぎ
痛い	いたい
優しい	やさしい
背景	はいけい
姿勢	しせい
否定	ひてい
証券	しょうけん
従来	じゅうらい
手段	しゅだん
危機	きき
裁判	さいばん
視点	してん
天皇	てんのう|すめらみこと
装備	そうび
困難	こんなん
我が家	わがや
無視	むし
優先	ゆうせん
翌日	よくじつ
沿い	そい|ぞい
看板	かんばん
貴重	きちょう
理論	りろん
収入	しゅうにゅう
収集	しゅうしゅう
解除	かいじょ
劇場	げきじょう
展望	てんぼう
資源	しげん
憲法	けんぽう
宣言	せんげん
貴方	あなた|きほう
若者	わかもの
紅葉	こうよう|もみじ
単純	たんじゅん
呼ぶ	よぶ
階段	かいだん
割引	わりびき
通勤	つうきん
宣伝	せんでん
回収	かいしゅう
若干	じゃっかん
退職	たいしょく
背中	せなか
何処	いずこ|どこ
帰宅	きたく
発揮	はっき
我が	わが
窓口	まどぐち
保障	ほしょう
遺産	いさん
論文	ろんぶん
筋肉	きんにく|すじにく
異なり	ことなり
立派	りっぱ
供給	きょうきゅう
沿線	えんせん
反映	はんえい
頂く	いただく
創造	そうぞう
人権	じんけん
収納	しゅうのう
重視	じゅうし
領域	りょういき
呼吸	こきゅう
巻き	まき
数値	すうち
延長	えんちょう
吸収	きゅうしゅう
至る	いたる
時刻	じこく
視線	しせん
従業	じゅうぎょう
山頂	さんちょう
内閣	ないかく
歌詞	かし
決済	けっさい
困る	こまる
結論	けつろん
宅配	たくはい
激しい	はげしい
創作	そうさく
割合	わりあい
衣装	いしょう
革命	かくめい
並びに	ならびに
女優	じょゆう
有難う	ありがとう
演劇	えんげき
並び	ならび
株価	かぶか
電源	でんげん
認証	にんしょう
口座	こうざ
温暖	おんだん
俳優	はいゆう
並べ	ならべ
認める	みとめる|したためる
心臓	しんぞう
疑い	うたがい
対処	たいしょ
創業	そうぎょう
混乱	こんらん
指揮	しき
興奮	こうふん
引退	いんたい
認知	にんち
株主	かぶぬし
論理	ろんり
厳選	げんせん
分割	ぶんかつ
届く	とどく
声優	せいゆう
臨時	りんじ
権力	けんりょく
散策	さんさく
就任	しゅうにん
幼児	ようじ|おさなご
収益	しゅうえき
若しくは	もしくわ
家賃	やちん
区域	くいき
誤解	ごかい
若手	わかて
誤り	あやまり
拝見	はいけん
年収	ねんしゅう
同盟	どうめい
牛乳	ぎゅうにゅう
加盟	かめい
閉店	へいてん
痛く	いたく
上映	じょうえい
除去	じょきょ
一層	いっそう
将軍	しょうぐん
割れ	われれ|われ
台詞	せりふ|ぜりふ|だいし
頂ける	いただける
系統	けいとう
暖かい	あたたかい
開幕	かいまく
署名	しょめい
政党	せいとう
閉じる	とじる
意欲	いよく
訪れる	おとずれる
砂糖	さとう|ざとう
郷土	きょうど
私立	しりつ|わたくしりつ
装着	そうちゃく
盛り	さかり|もり|ざかり
賃金	ちんぎん|ちんきん
並ぶ	ならぶ
並み	なみ
反射	はんしゃ
参拝	さんぱい
割り	わり
暮らす	くらす
簡易	かんい
拡張	かくちょう
補正	ほせい
深刻	しんこく
警備	けいび
激安	げきやす
届出	とどけで|とどけいで
尊敬	そんけい
従事	じゅうじ
密着	みっちゃく
返済	へんさい
危ない	あぶない
出勤	しゅっきん
連盟	れんめい
故障	こしょう
反論	はんろん
中傷	ちゅうしょう
故郷	こきょう|ふるさと
包装	ほうそう
頭痛	ずつう
推定	すいてい
策定	さくてい
諸国	しょこく
権限	けんげん
染め	そめ|しめ|ぞめ
幕府	ばくふ
紅茶	こうちゃ
片手	かたて
言い訳	いいわけ
源泉	げんせん
背後	はいご
体操	たいそう
非難	ひなん
県警	けんけい
勤め	つとめ|づとめ
推移	すいい
処置	しょち
承知	しょうち
降る	ふる|くだる
放映	ほうえい
聖書	せいしょ
優良	ゆうりょう
頂上	ちょうじょう
評論	ひょうろん
補給	ほきゅう
盛り上がり	もりあがり
体系	たいけい
服装	ふくそう
視野	しや
模型	もけい
預金	よきん
干し	ほし|ぼし
在宅	ざいたく
派手	はで
食欲	しょくよく
著書	ちょしょ
系列	けいれつ
感激	かんげき
盛ん	さかん|もん
推測	すいそく
収容	しゅうよう
俳句	はいく
縮小	しゅくしょう
注射	ちゅうしゃ
納期	のうき
供養	くよう
幼い	おさない|いとけない
呼びかけ	よびかけ
買収	ばいしゅう
片付け	かたづけ
安値	やすね
武将	ぶしょう
一人暮らし	ひとりぐらし
視察	しさつ
済む	すむ
展覧	てんらん
郵送	ゆうそう
秘書	ひしょ
広域	こういき
警告	けいこく
尊重	そんちょう
公認	こうにん
視界	しかい
討論	とうろん
内装	ないそう
納豆	なっとう
補足	ほそく
救済	きゅうさい
劇団	げきだん
大衆	たいしゅう|だいしゅ
郵政	ゆうせい
視覚	しかく
遺族	いぞく
財源	ざいげん
私的	してき
脳内	のうない
圧縮	あっしゅく
捨てる	すてる
創設	そうせつ
忘れる	わすれる
座席	ざせき
金銭	きんせん
武装	ぶそう
難い	かたい|がたい|にくい|にきい
世論	せろん|よろん|せいろん
補強	ほきょう
総裁	そうさい
至って	いたって
指針	ししん|ゆびばり
支障	ししょう
悲劇	ひげき
就業	しゅうぎょう
蒸し	ふかし|むし
公衆	こうしゅう
衆院	しゅういん
洗い	すすい|あらい
収め	おさめ
宝石	ほうせき
発射	はっしゃ
処方	しょほう
納税	のうぜい
探検	たんけん
担保	たんぽ
割と	わりと
創立	そうりつ
大将	たいしょう|だいしょう
延期	えんき
納付	のうふ
地蔵	じぞう
認可	にんか
貴族	きぞく
短縮	たんしゅく
共済	きょうさい
生存	せいぞん
急激	きゅうげき
出展	しゅってん
伝承	でんしょう
実装	じっそう
革新	かくしん
座り	すわり|ずわり
裏側	うらがわ
探せる	さがせる
日誌	にっし
質疑	しつぎ
並べて	なべて
翌年	よくとし|よくねん
幕末	ばくまつ
高値	たかね
進展	しんてん
運賃	うんちん
神秘	しんぴ
作詞	さくし
存続	そんぞく
貧困	ひんこん
異動	いどう
担う	になう|にのう
難し	むずかし|むつかし|がたし
熟成	じゅくせい
探る	さぐる
精密	せいみつ
県庁	けんちょう
苦痛	くつう
樹木	じゅもく
乱れ	みだれ
起源	きげん
視力	しりょく
預かり	あずかり
降りる	おりる
損傷	そんしょう
収支	しゅうし
地裁	ちさい
推理	すいり
遺体	いたい
冊子	さっし|そうし|ぞうし
担任	たんにん
存じ	ぞんじ
骨折	こっせつ
改装	かいそう
全域	ぜんいき
通訳	つうやく
片方	かたえ|かたかた|かたほう
批評	ひひょう
預け	あずけ
欲望	よくぼう
遺伝	いでん
難易	なんい
野党	やとう
密度	みつど
便秘	べんぴ
納め	おさめ
警官	けいかん
補修	ほしゅう
沿岸	えんがん
純正	じゅんせい
部署	ぶしょ
寸前	すんぜん
著名	ちょめい
売れ筋	うれすじ
洗面	せんめん
負傷	ふしょう
異議	いぎ
皇室	こうしつ
座る	すわる
内蔵	ないぞう|うちくら
退院	たいいん
兄貴	あにき
警報	けいほう
臓器	ぞうき
並木	なみき
領収	りょうしゅう
宅地	たくち
忠実	ちゅうじつ
遺言	ゆいごん|いげん|いごん
枚数	まいすう
純米	じゅんまい
賃料	ちんりょう
高層	こうそう
有り難う	ありがとう
一律	いちりつ
内臓	ないぞう
陛下	へいか
寸法	すんぽう
名詞	めいし
難民	なんみん
納入	のうにゅう
放射	ほうしゃ
蒸気	じょうき
民衆	みんしゅう
除外	じょがい
暮れ	くれ|ぐれ
異様	いよう
本尊	ほんぞん
値上げ	ねあげ
貴様	きさま
流域	りゅういき
値下げ	ねさげ
無難	ぶなん
音源	おんげん
誠実	せいじつ
納品	のうひん
紅白	こうはく
後退	こうたい
今晩	こんばん
過激	かげき
皇太子	こうたいし
洗う	あらう|あろう
馬券	ばけん
朗読	ろうどく
銭湯	せんとう
首脳	しゅのう
洗練	せんれん
聖人	せいじん|しょうにん
町並み	まちなみ
暖か	あたたか|あったか
分担	ぶんたん
胃腸	いちょう
自律	じりつ
差異	さい
毛穴	けあな
転勤	てんきん
密か	ひそか|みそか
創出	そうしゅつ
呼び出し	よびだし
貯蔵	ちょぞう
女将	おかみ|じょしょう
頂点	ちょうてん
優位	ゆうい
就活	しゅうかつ
垂れ	たれ|だれ
国宝	こくほう
映る	うつる
理系	りけい
変革	へんかく
照射	しょうしゃ
拡散	かくさん
宝くじ	たからくじ
厳密	げんみつ
整骨	せいこつ
産卵	さんらん
存分	ぞんぶん
大腸	だいちょう
階層	かいそう
垂直	すいちょく
論議	ろんぎ
論争	ろんそう
染色	せんしょく
重宝	ちょうほう|じゅうほう
お宅	おたく
翌朝	よくあさ|よくちょう
未熟	みじゅく
諸君	しょくん
宝物	たからもの|ほうもつ
傷害	しょうがい
退治	たいじ
創刊	そうかん
欲求	よっきゅう
昨晩	さくばん
貴女	あなた|きじょ
誤差	ごさ
洗顔	せんがん
主権	しゅけん
成熟	せいじゅく
幼虫	ようちゅう
磁気	じき
制裁	せいさい
礼拝	れいはい|らいはい
観覧	かんらん
特異	とくい
豆乳	とうにゅう
障がい	しょうがい
金券	きんけん
容姿	ようし
所蔵	しょぞう
独裁	どくさい
優待	ゆうたい
洗脳	せんのう
操縦	そうじゅう
庁舎	ちょうしゃ
異性	いせい
字幕	じまく
聖地	せいち
権者	ごんじゃ
星座	せいざ
専念	せんねん
相棒	あいぼう
吸引	きゅういん
共存	きょうそん|きょうぞん
従う	したがう|したごう
個展	こてん
乳がん	にゅうがん
幼少	ようしょう
就労	しゅうろう
退会	たいかい
痛感	つうかん
専業	せんぎょう
言論	げんろん
論点	ろんてん
現存	げんそん|げんぞん
劇的	げきてき
特権	とっけん
街並み	まちなみ
夕暮れ	ゆうぐれ
日系	にっけい
著しい	いちじるしい
至り	いたり
皇后	こうごう
創る	つくる|づくる
退場	たいじょう
乱暴	らんぼう
敗退	はいたい
利権	りけん
骨格	こっかく
吸う	すう
補完	ほかん
土砂	どしゃ
盛大	せいだい
容認	ようにん
従前	じゅうぜん
裏面	うらめん|りめん
海域	かいいき
断層	だんそう
血糖	けっとう
奏者	そうしゃ
専務	せんむ
電磁	でんじ
補佐	ほさ
乳幼児	にゅうようじ
届け出	とどけで|とどけいで
供述	きょうじゅつ
敬意	けいい
新潮	しんちょう
頭脳	ずのう
開閉	かいへい
激減	げきげん
根源	こんげん
母乳	ぼにゅう
除け	のけ|よけ|のぞけ
内視	ないし
探訪	たんぼう
並行	へいこう
方策	ほうさく
専有	せんゆう
源流	げんりゅう
値引き	ねびき
省庁	しょうちょう
党首	とうしゅ
片道	かたみち
疑う	うたがう|うたごう
語源	ごげん
探査	たんさ
段差	だんさ
格段	かくだん
密接	みっせつ
探求	たんきゅう
収縮	しゅうしゅく
若葉	わかば
新党	しんとう
果樹	かじゅ
賃借	ちんしゃく
無論	むろん
辞退	じたい
諸島	しょとう
誠意	せいい
背筋	せすじ|はいきん
腹部	ふくぶ
自我	じが
接骨	せっこつ
来訪	らいほう
成就	じょうじゅ
神聖	しんせい
傷み	いたみ
新株	しんかぶ
内訳	うちわけ
文系	ぶんけい
裏切り	うらぎり
延べ	のべ
夜勤	やきん
無敵	むてき
一刻	いっこく
就学	しゅうがく
機密	きみつ
従量	じゅうりょう
若年	じゃくねん
晩年	ばんねん
洗車	せんしゃ
勤労	きんろう
使い捨て	つかいすて
臨む	のぞむ
水源	すいげん
動詞	どうし
冷蔵	れいぞう
一筋	ひとすじ
熟練	じゅくれん
家系	かけい
復刻	ふっこく
川沿い	かわぞい
厳重	げんじゅう
深層	しんそう
切除	せつじょ
創建	そうけん
穀物	こくもつ
外装	がいそう
手洗い	てあらい
異例	いれい
一段	いちだん
簡潔	かんけつ
必至	ひっし
腹筋	ふっきん|はらすじ
分権	ぶんけん
至福	しふく
吸着	きゅうちゃく
女装	じょそう
最善	さいぜん
割り当て	わりあて
敵対	てきたい
圧巻	あっかん
本誌	ほんし
並べる	ならべる
専属	せんぞく
刻み	きざみ
染み	しみ|そみ|じみ
降臨	こうりん
高砂	たかさご
梅干	うめぼし
反乱	はんらん
専任	せんにん
毎晩	まいばん
宝庫	ほうこ
鉄鋼	てっこう
生誕	せいたん
筋力	きんりょく
防除	ぼうじょ
直射	ちょくしゃ
満腹	まんぷく
下段	かだん|げだん
裏技	うらわざ
片岡	かたおか
値上がり	ねあがり
蔵元	くらもと
外傷	がいしょう
車窓	しゃそう
特派	とくは
下降	かこう
難関	なんかん
上段	じょうだん
歌劇	かげき
授乳	じゅにゅう
訪ねる	たずねる
座談	ざだん
訳あり	わけあり
空腹	くうふく
縦走	じゅうそう
暮らせる	くらせる
厳格	げんかく
鉄骨	てっこつ
巻く	まく
乳児	にゅうじ
難点	なんてん
蒸留	じょうりゅう
観劇	かんげき
官庁	かんちょう
異国	いこく
段ボール	だんぼーる
討ち	うち
格納	かくのう
磁石	じしゃく
別冊	べっさつ
至高	しこう
臨海	りんかい
閣議	かくぎ
賛否	さんぴ
聖堂	せいどう
切り捨て	きりすて
激戦	げきせん
一寸	ちょっと
座長	ざちょう
仏閣	ぶっかく
操る	あやつる
私鉄	してつ
宗派	しゅうは
熟語	じゅくご
干物	ひもの|ほしもの
水系	すいけい
腹痛	ふくつう|はらいた
伝染	でんせん
痛む	いたむ
常勤	じょうきん
装い	よそおい|よそい
善意	ぜんい
風潮	ふうちょう
操業	そうぎょう
障子	しょうじ
片側	かたがわ
降下	こうか
正論	せいろん
重傷	おもで|じゅうしょう
派生	はせい
断片	だんぺん
脳裏	のうり
書簡	しょかん
敬遠	けいえん
潮流	ちょうりゅう
宣告	せんこく
同署	どうしょ
植樹	しょくじゅ
胸元	むなもと
可視	かし
除雪	じょせつ
蔵書	ぞうしょ
届け日	とどけび
砂利	じゃり
補う	おぎなう|おぎのう
大盛り	おおもり
皇族	こうぞく
敬老	けいろう
筋トレ	きんとれ
全巻	ぜんかん
降ろし	おろし
石段	いしだん
皇子	おうじ|こうし|みこ
上層	じょうそう
秘伝	ひでん
暮し	くらし|ぐらし
呼び名	よびな
異論	いろん
片づけ	かたづけ
延び	のび
値打ち	ねうち
誤字	ごじ
酒蔵	さかぐら
居宅	きょたく
論者	ろんしゃ
変異	へんい
敬語	けいご
盛り合わせ	もりあわせ
官公庁	かんこうちょう
若松	わかまつ
異変	いへん
異物	いぶつ|こともの
独創	どくそう
会派	かいは
背面	はいめん
担い手	にないて
黒糖	こくとう
共著	きょうちょ
届ける	とどける
主将	しゅしょう
忠告	ちゅうこく
射程	しゃてい
座標	ざひょう
難病	なんびょう
退社	たいしゃ
尊厳	そんげん
遺構	いこう
卵巣	らんそう
和装	わそう
割安	わりやす
遊覧	ゆうらん
優勢	ゆうせい
奏でる	かなでる
可否	かひ
高裁	こうさい
刻印	こくいん
勤める	つとめる
供する	きょうする
乱入	らんにゅう
段取り	だんどり
蒸発	じょうはつ
厳禁	げんきん
完熟	かんじゅく
呼ばわり	よばわり
穴場	あなば
散乱	さんらん
収束	しゅうそく
難解	なんかい
裏付け	うらづけ
収まる	おさまる
退去	たいきょ
王座	おうざ
模試	もし
残存	ざんそん|ざんぞん
税収	ぜいしゅう
簡素	かんそ
喜劇	きげき
探り	さぐり
従軍	じゅうぐん
割る	われる|わる
今晩は	こんばんは
亡命	ぼうめい
裏話	うらばなし
閣下	かっか|こうか
土俵	どひょう
腸内	ちょうない
泉質	せんしつ
子宝	こだから
劇中	げきちゅう
鉄筋	てっきん
沿革	えんかく
小銭	こぜに
土下座	どげざ
降水	こうすい
納車	のうしゃ
激化	げきか|げっか
宝箱	たからばこ
短冊	たんざく|たんじゃく
閉会	へいかい
呼べる	よべる
社宅	しゃたく
除草	じょそう
落とし穴	おとしあな
預言	よげん
私服	しふく
高専	こうせん
干支	えと|かんし
降格	こうかく
火傷	やけど|かしょう
新装	しんそう
裏表	うらおもて
梅干し	うめぼし
貴社	きしゃ
傷つける	きずつける
有り難い	ありがたい
府警	ふけい
至上	しじょう
連呼	れんこ
巻末	かんまつ
裁量	さいりょう
雑穀	ざっこく
討議	とうぎ
党員	とういん
映り	うつり
密集	みっしゅう
破片	はへん
波乱	はらん
段落	だんらく
干潟	ひがた
映え	はえ|ばえ
軽視	けいし
裏腹	うらはら
道筋	みちすじ
親善	しんぜん
改憲	かいけん
並列	へいれつ
王将	おうしょう
縦断	じゅうだん
所存	しょぞん
絶頂	ぜっちょう
出納	すいとう
届け先	とどけさき
結納	ゆいのう
度胸	どきょう
水域	すいいき
幼女	ようじょ
苦難	くなん
皇居	こうきょ
激動	げきどう
異色	いしょく
秘境	ひきょう
洗礼	せんれい
遺物	いぶつ
染まる	そまる
首筋	くびすじ
博覧	はくらん
樹林	じゅりん
中将	ちゅうじょう
宅建	たっけん
編著	へんちょ
巻頭	かんとう
映える	はえる
有難い	ありがたい
蒸し暑い	むしあちい|むしあつい
電脳	でんのう
規律	きりつ
収める	おさめる
将校	しょうこう
至極	しごく
重奏	じゅうそう
遺品	いひん
飛び降り	とびおり|とびくだり
欠片	かけら|けっぺん
大蔵	おおくら|だいぞう
密教	みっきょう
臨場	りんじょう
遺骨	いこつ
退任	たいにん
樹立	じゅりつ|こだち
退散	たいさん
忠誠	ちゅうせい
創始	そうし
豊胸	ほうきょう
中腹	ちゅうふく|なかはら
大樹	たいじゅ
終値	おわりね
射殺	しゃさつ
水洗い	みずあらい
登頂	とうちょう|とちょう
亡くなる	なくなる
若返り	わかがえり
石灰	せっかい|いしばい
論外	ろんがい
最盛	さいせい
中退	ちゅうたい
朝晩	あさばん
胸部	きょうぶ
否認	ひにん
優美	ゆうび
正座	せいざ
三蔵	さんぞう
極秘	ごくひ
推察	すいさつ
幼なじみ	おさななじみ
肺がん	はいがん
地層	ちそう
夕刻	ゆうこく
激痛	げきつう
教皇	きょうこう
割高	わりだか
恩返し	おんがえし
垂れ流し	たれながし
磁場	じば|じじょう
背骨	せぼね
至近	しきん
署長	しょちょう
真紅	しんく
訳者	やくしゃ
傷口	きずぐち
裏手	うらて
推計	すいけい
下層	かそう
警部	けいぶ
延命	えんめい
密室	みっしつ
秘湯	ひとう
絵巻	えまき
異質	いしつ
尊い	たっとい|とうとい
染料	せんりょう
窓際	まどぎわ
温存	おんぞん
忘れ物	わすれもの
翌月	よくげつ
恩師	おんし
弁済	べんさい
就いて	ついて
聖母	せいぼ
盛り付け	もりつけ
疑似	ぎじ
刻む	きざむ
表層	ひょうそう
気密	きみつ
拝観	はいかん
裏返し	うらがえし
退学	たいがく
災難	さいなん
秘話	ひわ
権現	ごんげん
収蔵	しゅうぞう
至急	しきゅう
足裏	あしうら
光源	こうげん
沿道	えんどう
死傷	ししょう
朗報	ろうほう
密閉	みっぺい
降雨	こうう
党内	とうない
合奏	がっそう
流派	りゅうは
切腹	せっぷく
純一	じゅんいつ
内覧	ないらん
帯域	たいいき
両論	りょうろん
吸入	きゅうにゅう
純情	じゅんじょう
台座	だいざ
卒論	そつろん
後ろ姿	うしろすがた
系図	けいず
脳死	のうし
乱立	らんりつ
殺傷	さっしょう
担ぎ	かつぎ
片足	かたあし
下巻	げかん
割増	わりまし
収まり	おさまり
男優	だんゆう
正絹	しょうけん
高貴	こうき
善悪	ぜんあく
ひび割れ	ひびわれ
月収	げっしゅう
砂防	さぼう
探知	たんち
垂水	たるみ
背負う	せおう|しょう
縮尺	しゅくしゃく
降板	こうばん
割れる	われる
乗降	じょうこう
私学	しがく
低脳	ていのう
株券	かぶけん
預ける	あずける
尺八	しゃくはち
君臨	くんりん
海沿い	うみぞい
鋼板	こうはん
仮装	かそう
晩秋	ばんしゅう
支庁	しちょう
探究	たんきゅう
一巻	いっかん
紅い	あかい
片思い	かたおもい
物欲	ぶつよく
裏金	うらがね
熟し	じゅくし|こなし
歯並び	はならび
就く	つく|づく
画策	かくさく
納める	おさめる
割愛	かつあい
弁論	べんろん
遺書	いしょ
陽射し	ひざし
近視	きんし
否決	ひけつ
厳守	げんしゅ
裏切る	うらぎる
染める	そめる
鋼鉄	こうてつ
派兵	はへい
灰皿	はいざら
臨界	りんかい
山系	さんけい
異名	いみょう|いめい
痛快	つうかい
黒潮	くろしお
退団	たいだん
裏山	うらやま
憲章	けんしょう
純度	じゅんど
割当	わりあて
吸水	きゅうすい
創意	そうい
権益	けんえき
体裁	ていさい
純白	じゅんぱく
賃貸借	ちんたいしゃく
別段	べつだん
版権	はんけん
乱用	らんよう
傷つく	きずつく
直視	ちょくし
就航	しゅうこう
裁き	さばき
国策	こくさく
危害	きがい
縦横	じゅうおう|たてよこ
背負い	せおい|しょい
強敵	きょうてき|ごうてき
衆生	しゅじょう
裏地	うらじ
注視	ちゅうし
我家	わがや
幕開け	まくあけ
誤認	ごにん
磁性	じせい
客層	きゃくそう
晩飯	ばんめし
傷病	しょうびょう
親密	しんみつ
穴子	あなご
古泉	こせん
潮風	しおかぜ
専ら	もっぱら
降雪	こうせつ
綿密	めんみつ
善良	ぜんりょう
済ませる	すませる
従兄弟	いとこ|じゅうけいてい
供用	きょうよう
持論	じろん
論じる	ろんじる
積層	せきそう
尺度	しゃくど
黒幕	くろまく
天敵	てんてき
悪党	あくとう
秘宝	ひほう
目視	もくし
机上	きじょう
納骨	のうこつ
激変	げきへん
上値	うわね
値動き	ねうごき
聖域	せいいき
私見	しけん
装束	しょうぞく
和訳	わやく
閉館	へいかん
退け	しりぞけ|どけ|のけ|ひけ
皮革	ひかく
簡略	かんりゃく
痛風	つうふう
連射	れんしゃ
裁定	さいてい
純愛	じゅんあい
無痛	むつう
下腹	かふく|したはら
補欠	ほけつ
一派	いっぱ
晩ご飯	ばんごはん
熟知	じゅくち
危うい	あやうい
書誌	しょし
片付ける	かたづける
洗える	あらえる
後姿	うしろすがた
厳正	げんせい
勤続	きんぞく
閉める	しめる
異形	いぎょう|いけい
呼び捨て	よびすて
本庁	ほんちょう
糖質	とうしつ
拝借	はいしゃく
宣戦	せんせん
敬愛	けいあい
名著	めいちょ
従属	じゅうぞく
値下がり	ねさがり
人並み	ひとなみ
欲張り	よくばり
糖度	とうど
鋼材	こうざい
利己	りこ
専修	せんしゅう
裁断	さいだん
皇女	おうじょ|こうじょ|ひめみこ|みこ
除名	じょめい
勤勉	きんべん
糖分	とうぶん
聖火	せいか
論調	ろんちょう
増収	ぞうしゅう
操り	あやつり
真っ盛り	まっさかり
揮発	きはつ
班長	はんちょう
真宗	しんしゅう
補習	ほしゅう
黄砂	こうさ
服従	ふくじゅう
疑念	ぎねん
磁器	じき
未納	みのう
視認	しにん
決裁	けっさい
収量	しゅうりょう
純金	じゅんきん
論説	ろんせつ
右脳	うのう
加担	かたん
追従	ついじゅう|ついしょう
中段	ちゅうだん
英訳	えいやく
山並み	やまなみ
黄泉	こうせん|よみ
専科	せんか
仲裁	ちゅうさい
便座	べんざ
俳人	はいじん
胃がん	いがん
私大	しだい
巻き上げ	まきあげ
看病	かんびょう
左派	さは
半熟	はんじゅく
延びる	のびる
呼応	こおう
仁義	じんぎ
私事	しじ|わたくしごと
若宮	わかみや
難航	なんこう
諸説	しょせつ
難題	なんだい
巻物	まきもの
雨降り	あめふり
策略	さくりゃく
乳酸	にゅうさん
暖冬	だんとう
一樹	いちじゅ
推論	すいろん
宗家	そうけ
公私	こうし
口紅	くちべに
針金	はりがね
上巻	じょうかん
裏方	うらかた
帰郷	ききょう
無傷	むきず
収拾	しゅうしゅう
樹海	じゅかい
干す	ほす
善人	ぜんにん
卵黄	らんおう
減退	げんたい
心肺	しんぱい
難問	なんもん
低層	ていそう
券売	けんばい
供え	そなえ
親権	しんけん
簡便	かんべん
己が	おのが
発券	はっけん
紅色	こうしょく|べにいろ
装丁	そうてい
沿う	そう
ひとり暮らし	ひとりぐらし
映す	うつす
優れもの	すぐれもの
私物	しぶつ
私設	しせつ
少将	しょうしょう
乱れる	みだれる
密約	みつやく
変装	へんそう
秘蔵	ひぞう|ひぞ
直腸	ちょくちょう
片面	かためん
山盛り	やまもり
疑わしい	うたがわしい
屋根裏	やねうら
論破	ろんぱ
至難	しなん
砂地	すなじ|すなち
増補	ぞうほ
至る所	いたるところ
若菜	わかな
訪日	ほうにち
心筋	しんきん
感傷	かんしょう
乳頭	にゅうとう
街宣	がいせん
仁王	におう
忠義	ちゅうぎ
署員	しょいん
源平	げんぺい
舌打ち	したうち
難なく	なんなく
窓辺	まどべ
特段	とくだん
清純	せいじゅん
従順	じゅうじゅん
糖類	とうるい
装具	そうぐ
自腹	じばら
縮毛	しゅくもう
戦乱	せんらん
音域	おんいき
定刻	ていこく
熟年	じゅくねん
警護	けいご
暮れる	くれる
ゆで卵	ゆでたまご
毒舌	どくぜつ
一座	いちざ
射出	しゃしゅつ
密輸	みつゆ
減収	げんしゅう
土砂降り	どしゃぶり
聖戦	せいせん
水洗	すいせん
下値	したね
持株	もちかぶ
背もたれ	せもたれ
直系	ちょっけい
乳液	にゅうえき
難所	なんしょ
受難	じゅなん
観衆	かんしゅう
完済	かんさい
野暮	やぼ
口論	こうろん
預かる	あずかる
穴あけ	あなあけ
専売	せんばい
鋼管	こうかん
目処	めど
奮戦	ふんせん
郷里	きょうり|ごうり
降順	こうじゅん
諸氏	しょし
てんこ盛り	てんこもり
家宅	かたく
激務	げきむ
鉱泉	こうせん
都庁	とちょう
拝読	はいどく
本筋	ほんすじ
全盛	ぜんせい
皇位	こうい
冬至	とうじ
持ち株	もちかぶ
創世	そうせい
日勤	にっきん
敵国	てきこく|てっこく
割れ目	われめ
小刻み	こきざみ
脳波	のうは
就農	しゅうのう
家宝	かほう
宣教	せんきょう
春巻き	はるまき
論評	ろんぴょう
骨太	ほねぶと
裏打ち	うらうち
習熟	しゅうじゅく
土蔵	どぞう
復権	ふっけん
誤用	ごよう
道沿い	みちぞい
安否	あんぴ
群衆	ぐんしゅう
合否	ごうひ
聖職	せいしょく
歯痛	しつう|はいた
樹皮	じゅひ
敵意	てきい
存する	そんする
若し	もし|わかし
宝島	たからじま
手探り	てさぐり
市域	しいき
再訪	さいほう
従者	じゅうしゃ
大層	たいそう
片目	かため
悲痛	ひつう
高座	こうざ
裏庭	うらにわ
調律	ちょうりつ
激増	げきぞう
目論見	もくろみ
処する	しょする
小腸	しょうちょう
裁決	さいけつ
恩給	おんきゅう
吸気	きゅうき
吸い物	すいもの
水郷	すいきょう|すいごう
異種	いしゅ
血筋	ちすじ
紅梅	こうばい
直訳	ちょくやく
敬礼	けいれい
洗い場	あらいば
蔵人	くらびと|くろうど|くらうどの|くらんど
取り巻き	とりまき
一党	いっとう
誌面	しめん
裁く	さばく
未亡人	みぼうじん
裏付ける	うらづける
同窓	どうそう
誤算	ごさん
誌上	しじょう
若草	わかくさ
返納	へんのう
聖歌	せいか
動乱	どうらん
大脳	だいのう
射手	いて|いで|しゃしゅ
助詞	じょし
腸管	ちょうかん
表裏	ひょうり|おもてうら
律法	りっぽう
物干し	ものほし
探し物	さがしもの
初段	しょだん
回覧	かいらん
退化	たいか
裏目	うらめ
預入	あずけいれ
表敬	ひょうけい
総論	そうろん
砂場	すなば
骨子	こっし
退出	たいしゅつ
善行	ぜんこう
工賃	こうちん
翌週	よくしゅう
名将	めいしょう
腹ごしらえ	はらごしらえ
痛み止め	いたみどめ
財宝	ざいほう
上皇	じょうこう
ポイ捨て	ぽいすて
夏至	げし
割引き	わりびき
幼年	ようねん
前段	ぜんだん
前奏	ぜんそう
町域	ちょういき
射す	さす
著作権	ちょさくけん
誕生日	たんじょうび
障害者	しょうがいしゃ
看護師	かんごし
私達	わたしたち
専門店	せんもんてん
担当者	たんとうしゃ
専門家	せんもんか
容疑者	ようぎしゃ
遺伝子	いでんし
従業員	じゅうぎょういん
温暖化	おんだんか
郵便局	ゆうびんきょく
裁判所	さいばんしょ|さいばんじょ
大規模	だいきぼ
冷蔵庫	れいぞうこ
子供達	こどもたち
選手権	せんしゅけん
経済的	けいざいてき
私自身	わたしじしん
補助金	ほじょきん
価値観	かちかん
航空券	こうくうけん
放射線	ほうしゃせん
展覧会	てんらんかい
衆議院	しゅうぎいん
展示会	てんじかい
映画館	えいがかん
存在感	そんざいかん
検討中	けんとうちゅう
危険性	きけんせい
専門医	せんもんい
候補者	こうほしゃ
演奏会	えんそうかい
警察官	けいさつかん
著作物	ちょさくぶつ
小規模	しょうきぼ
時刻表	じこくひょう
同窓会	どうそうかい
難易度	なんいど
裁判官	さいばんかん
経済学	けいざいがく
宅配便	たくはいびん
評論家	ひょうろんか
住宅街	じゅうたくがい
警察署	けいさつしょ
住宅地	じゅうたくち
映画化	えいがか
領収書	りょうしゅうしょ
専門的	せんもんてき
忘年会	ぼうねんかい
勤務地	きんむち
情報誌	じょうほうし
看護婦	かんごふ
立候補	りっこうほ
裁判員	さいばんいん
論理的	ろんりてき
時代劇	じだいげき
筋肉痛	きんにくつう
映画祭	えいがさい
最高裁	さいこうさい
展示場	てんじじょう
将来的	しょうらいてき
灰色	はいいろ
所有権	しょゆうけん
翌営業日	よくえいぎょうび
非常勤	ひじょうきん
生態系	せいたいけい
写真展	しゃしんてん
危機感	ききかん
一覧表	いちらんひょう
退職金	たいしょくきん
内視鏡	ないしきょう
経験値	けいけんち
呼吸器	こきゅうき
指揮者	しきしゃ
神経痛	しんけいつう
週刊誌	しゅうかんし
電磁波	でんじは
加盟店	かめいてん
税務署	ぜいむしょ
有権者	ゆうけんしゃ
障害児	しょうがいじ
外資系	がいしけい
従量制	じゅうりょうせい
最優先	さいゆうせん
参政権	さんせいけん
従事者	じゅうじしゃ
何枚	なんまい
理論的	りろんてき
準優勝	じゅんゆうしょう
温泉郷	おんせんきょう
乗車券	じょうしゃけん
訪問者	ほうもんしゃ
特派員	とくはいん
宗教的	しゅうきょうてき
神秘的	しんぴてき
接骨院	せっこついん
予約権	よやくけん
財産権	ざいさんけん
座談会	ざだんかい
衆院選	しゅういんせん
警備員	けいびいん
否定的	ひていてき
作品展	さくひんてん
貴金属	ききんぞく
勤務先	きんむさき
再認識	さいにんしき
背番号	せばんごう
再就職	さいしゅうしょく
負担金	ふたんきん
温泉街	おんせんがい
一段落	いちだんらく
消防署	しょうぼうしょ
対処法	たいしょほう
放射性	ほうしゃせい
高収入	こうしゅうにゅう
批判的	ひはんてき
指揮官	しきかん
小冊子	しょうさっし
協奏曲	きょうそうきょく
商品券	しょうひんけん
座布団	ざぶとん
専門職	せんもんしょく
方法論	ほうほうろん
郵便物	ゆうびんぶつ
創業者	そうぎょうしゃ
代名詞	だいめいし
操作性	そうさせい
裁判長	さいばんちょう
脳卒中	のうそっちゅう
情報源	じょうほうげん
収容所	しゅうようじょ
脳神経	のうしんけい
展示室	てんじしつ
反対派	はんたいは
放射能	ほうしゃのう
重要視	じゅうようし
入場券	にゅうじょうけん
血糖値	けっとうち
宇宙船	うちゅうせん
全盛期	ぜんせいき
洗面所	せんめんじょ
整理券	せいりけん
危険物	きけんぶつ
権力者	けんりょくしゃ
純利益	じゅんりえき
上映会	じょうえいかい
優先的	ゆうせんてき
専門性	せんもんせい
博覧会	はくらんかい
法律上	ほうりつじょう
乳製品	にゅうせいひん
少数派	しょうすうは
諸外国	しょがいこく
開幕戦	かいまくせん
時系列	じけいれつ
最盛期	さいせいき
平均値	へいきんち
金銭的	きんせんてき
臨場感	りんじょうかん
感染者	かんせんしゃ
特別展	とくべつてん
深呼吸	しんこきゅう
就職先	しゅうしょくさき
納税者	のうぜいしゃ
諸事情	しょじじょう
水蒸気	すいじょうき
障害物	しょうがいぶつ
再検討	さいけんとう
天皇制	てんのうせい
純米酒	じゅんまいしゅ
正統派	せいとうは
染色体	せんしょくたい
私生活	しせいかつ
主導権	しゅどうけん
段階的	だんかいてき
選挙権	せんきょけん
未確認	みかくにん
優勝者	ゆうしょうしゃ
議決権	ぎけつけん
天守閣	てんしゅかく
心臓病	しんぞうびょう
基準値	きじゅんち
意欲的	いよくてき
死亡率	しぼうりつ
将来性	しょうらいせい
可視化	かしか
割引券	わりびきけん
対応策	たいおうさく
処分場	しょぶんじょう
観覧車	かんらんしゃ
演奏家	えんそうか
革新的	かくしんてき
合衆国	がっしゅうこく
大聖堂	だいせいどう
独創的	どくそうてき
問題視	もんだいし
備忘録	びぼうろく
討論会	とうろんかい
純資産	じゅんしさん
月刊誌	げっかんし
創造性	そうぞうせい
従業者	じゅうぎょうしゃ
創造的	そうぞうてき
視覚的	しかくてき
体系的	たいけいてき
勤労者	きんろうしゃ
優等生	ゆうとうせい
届出書	とどけでしょ
太陽系	たいようけい
実力派	じつりょくは
形容詞	けいようし
親孝行	おやこうこう
広葉樹	こうようじゅ
映像化	えいぞうか
加盟国	かめいこく
伝染病	でんせんびょう
遊覧船	ゆうらんせん
反射的	はんしゃてき
探査機	たんさき
優位性	ゆういせい
創始者	そうししゃ
進化論	しんかろん
定期券	ていきけん
生演奏	なまえんそう
預言者	よげんしゃ
小論文	しょうろんぶん
経済力	けいざいりょく
果樹園	かじゅえん
深刻化	しんこくか
洗面台	せんめんだい
危険度	きけんど
生理痛	せいりつう
不純物	ふじゅんぶつ
人形劇	にんぎょうげき
将軍家	しょうぐんけ
危機的	ききてき
物産展	ぶっさんてん
著作者	ちょさくしゃ
街路樹	がいろじゅ
再処理	さいしょり
退職後	たいしょくご
特許権	とっきょけん
宣教師	せんきょうし
看護士	かんごし
雨模様	あめもよう
下腹部	かふくぶ
神経系	しんけいけい
借地権	しゃくちけん
高密度	こうみつど
熱処理	ねつしょり
来訪者	らいほうしゃ
負傷者	ふしょうしゃ
総裁選	そうさいせん
退職者	たいしょくしゃ
独裁者	どくさいしゃ
四重奏	しじゅうそう
誕生会	たんじょうかい
創造力	そうぞうりょく
貴重品	きちょうひん
券売機	けんばいき
多数派	たすうは
訪問着	ほうもんぎ
演奏者	えんそうしゃ
過激派	かげきは
延長線	えんちょうせん
当日券	とうじつけん
自尊心	じそんしん
広報誌	こうほうし
保存料	ほぞんりょう
勤務医	きんむい
異次元	いじげん
展開中	てんかいちゅう
呼吸法	こきゅうほう
革命的	かくめいてき
経済性	けいざいせい
担当相	たんとうしょう
参拝者	さんぱいしゃ
経済界	けいざいかい
拡張子	かくちょうし
死亡者	しぼうしゃ
幼少期	ようしょうき
大納言	だいなごん
針葉樹	しんようじゅ
横断幕	おうだんまく
背景色	はいけいしょく
簡素化	かんそか
負担額	ふたんがく
幼児期	ようじき
回数券	かいすうけん
自衛権	じえいけん
批評家	ひひょうか
担当医	たんとうい
水資源	みずしげん
深層水	しんそうすい
降水量	こうすいりょう
保守派	ほしゅは
展示物	てんじぶつ
用心棒	ようじんぼう
同盟国	どうめいこく
商標権	しょうひょうけん
技術系	ぎじゅつけい