検索	けんさく
購入	こうにゅう
一緒	いっしょ
戻る	もどる
ヶ月	かげつ
監督	かんとく
雰囲気	ふんいき
釣り	つり|づり
患者	かんじゃ
金融	きんゆう
充実	じゅうじつ
風呂	ふろ|ぶろ
分析	ぶんせき
馬鹿	ばか
診療	しんりょう
挑戦	ちょうせん
症状	しょうじょう
診断	しんだん
嫌い	きらい|ぎらい
挨拶	あいさつ
実践	じっせん
凄い	すごい
眺め	ながめ
余裕	よゆう
無駄	むだ
合併	がっぺい
丁寧	ていねい
唯一	ゆいいつ|ゆいつ
栽培	さいばい
化粧	けしょう|げしょう
弊社	へいしゃ
廃止	はいし
解析	かいせき
貢献	こうけん
駄目	だめ
癒し	いやし
購読	こうどく
履歴	りれき
戻り	もどり
妊娠	にんしん
宜しく	よろしく
焼酎	しょうちゅう|じょうちゅう
頑張り	がんばり
交渉	こうしょう
洗濯	せんたく
徹底	てってい
旦那	だんな
貼り	はり|ばり
銘柄	めいがら
矯正	きょうせい
把握	はあく
妄想	もうそう|もうぞう
必須	ひっす|ひっしゅ
疾患	しっかん
捜査	そうさ
臭い	におい|くさい
狙い	ねらい
懐かしい	なつかしい
一括	いっかつ
充分	じゅうぶん
搭載	とうさい
生涯	しょうがい
廃棄	はいき
堪能	たんのう|かんのう
匂い	におい
訴訟	そしょう
披露	ひろう
拒否	きょひ
諦め	あきらめ
詐欺	さぎ
報酬	ほうしゅう
循環	じゅんかん
山梨	やまなし|やまなし
繊維	せんい
椅子	いす
推薦	すいせん
完璧	かんぺき
探偵	たんてい
稽古	けいこ|げいこ
睡眠	すいみん
憧れ	あこがれ|あくがれ
麻生	おふ
賠償	ばいしょう
但し	ただし
漬け	つけ|づけ
渋滞	じゅうたい
融資	ゆうし
官僚	かんりょう
補償	ほしょう
同僚	どうりょう
酷い	ひどい|むごい
文献	ぶんけん
日頃	ひごろ
過剰	かじょう
受診	じゅしん
推奨	すいしょう
相撲	すもう|ずもう|すまい
免疫	めんえき
戻す	もどす
爽やか	さわやか
一旦	いったん
拉致	らち|らっち
診察	しんさつ
洗浄	せんじょう
倫理	りんり
狙う	ねらう|ねろう
懸念	けねん
撤退	てったい
頻繁	ひんぱん
検診	けんしん
表彰	ひょうしょう
頑張る	がんばる
迅速	じんそく
融合	ゆうごう
土壌	どじょう
僅か	わずか|はつか
返還	へんかん
親戚	しんせき
痩せ	やせ
水槽	すいそう
褒め	ほめ|ぼめ
一斉	いっせい
挿入	そうにゅう
充電	じゅうでん
隙間	すきま
柔軟	じゅうなん
傑作	けっさく
併用	へいよう
破綻	はたん
機嫌	きげん
昆虫	こんちゅう
庶民	しょみん
発症	はっしょう
ヵ月	かげつ
稼ぎ	かせぎ
昆布	こぶ|こんぶ
歌舞伎	かぶき
ヶ所	かしょ
還元	かんげん
別荘	べっそう
妥当	だとう
稼ぐ	かせぐ
繊細	せんさい
素朴	そぼく
妖怪	ようかい
頻度	ひんど
磨き	みがき
偏差	へんさ
貼る	はる|ばる
無償	むしょう
腫瘍	しゅよう
媒体	ばいたい
曖昧	あいまい
眺める	ながめる
所詮	しょせん
逸品	いっぴん
撤去	てっきょ
抹茶	まっちゃ
蹴り	けり|げり
探索	たんさく
潰し	つぶし|つやし
麻酔	ますい
釣果	ちょうか
浄化	じょうか
症例	しょうれい
今頃	いまごろ
細菌	さいきん
嫉妬	しっと
薦め	すすめ
忍者	にんじゃ
艦隊	かんたい
渓谷	けいこく
羨ましい	うらやましい
洞窟	どうくつ
石垣	いしがき|いしがけ
涼しい	すずしい
船舶	せんぱく
懇談	こんだん
偽装	ぎそう
砂漠	さばく
眺望	ちょうぼう
頂戴	ちょうだい
肯定	こうてい
妖精	ようせい
懐かし	なつかし
帰還	きかん
不倫	ふりん
玩具	がんぐ|おもちゃ
網羅	もうら
三昧	さんまい|ざんまい
憂鬱	ゆううつ
附属	ふぞく
洪水	こうずい
紳士	しんし
不妊	ふにん
教諭	きょうゆ
併設	へいせつ
附則	ふそく
愚痴	ぐち
弥生	やよい
管轄	かんかつ
縄文	じょうもん
楽譜	がくふ
懐石	かいせき
捜索	そうさく
吟醸	ぎんじょう
示唆	しさ
制覇	せいは
稼働	かどう
情緒	じょうしょ|じょうちょ
醸造	じょうぞう
発祥	はっしょう
炎症	えんしょう
爽快	そうかい
取り戻し	とりもどし
下痢	げり
肖像	しょうぞう|ちょさん
秩序	ちつじょ
消耗	しょうもう|しょうこう
妊婦	にんぷ
潰れ	つぶれ
欠陥	けっかん
美肌	びはだ
蛍光	けいこう
賭け	かけ|がけ
山荘	さんそう
喪失	そうしつ
斬り	きり|ぎり
挑む	いどむ
泥棒	どろぼう
封筒	ふうとう|ぶうとう
懇親	こんしん
戦艦	せんかん
漬物	つけもの
呪い	のろい|まじない
本棚	ほんだな
干渉	かんしょう
模索	もさく
献金	けんきん
過疎	かそ
偏見	へんけん
恐竜	きょうりゅう
渓流	けいりゅう
触媒	しょくばい
中核	ちゅうかく
貼付	ちょうふ|てんぷ
懲役	ちょうえき
且つ	かつ
妥協	だきょう
補充	ほじゅう
高騰	こうとう
硫黄	いおう|ゆおう
壮大	そうだい
総括	そうかつ
麻薬	まやく
津波	つなみ
僧侶	そうりょ
奨励	しょうれい
誓い	ちかい
愉快	ゆかい
病棟	びょうとう
懸賞	けんしょう
釣れる	つれる
虚偽	きょぎ
靴下	くつした
拡充	かくじゅう
囲碁	いご
呪文	じゅもん
残酷	ざんこく
治癒	ちゆ
浴槽	よくそう
償却	しょうきゃく
顕著	けんちょ
腫れ	はれ
嫌がらせ	いやがらせ
培養	ばいよう
暗闇	くらやみ
閑静	かんせい
藤本	とうほん
尻尾	しっぽ
真珠	しんじゅ
扶養	ふよう
解剖	かいぼう
変遷	へんせん
挫折	ざせつ
枠組み	わくぐみ
猶予	ゆうよ
履き	はき|ばき
廃車	はいしゃ
搭乗	とうじょう
手頃	てごろ
稼動	かどう
殺菌	さっきん
覚醒	かくせい
過酷	かこく
包括	ほうかつ
法廷	ほうてい
厄介	やっかい
模擬	もぎ
撤回	てっかい
大嫌い	だいきらい
斬新	ざんしん
腎臓	じんぞう
重症	じゅうしょう
追悼	ついとう
沸騰	ふっとう
連覇	れんぱ
誘拐	ゆうかい
普遍	ふへん
内緒	ないしょ
奨学	しょうがく
嫌悪	けんお
摩擦	まさつ
主宰	しゅさい
川柳	せんりゅう|かわやなぎ
刃物	はもの
痴漢	ちかん
懲戒	ちょうかい
稼げる	かせげる
月頃	つきごろ
補佐	ほさ
褒美	ほうび
山麓	さんろく
遮断	しゃだん
料亭	りょうてい
閣僚	かくりょう
拒絶	きょぜつ
懸命	けんめい
徹夜	てつや
真摯	しんし
汎用	はんよう
毀損	きそん
磨く	みがく
勾配	こうばい
大相撲	おおずもう
献立	こんだて
釣り場	つりば
履修	りしゅう
口臭	こうしゅう
見頃	みごろ
抗菌	こうきん
挑発	ちょうはつ
拭い	ふい|ぬぐい
捉える	とらえる|つらまえる
葛藤	かっとう|つづらふじ
購買	こうばい
大麻	たいま
中枢	ちゅうすう
大佐	たいさ
杉山	すぎやま
初詣	はつもうで
奨め	すすめ
浄水	じょうすい
婚姻	こんいん
股間	こかん
斎場	さいじょう
近頃	ちかごろ
冥福	めいふく
片隅	かたすみ
遍路	へんろ
贈呈	ぞうてい
進捗	しんちょく
叔父	おじ|しゅくふ
頑固	がんこ
余韻	よいん
刹那	せつな
缶詰	かんづめ
下駄	げた
併合	へいごう
元旦	がんたん
研磨	けんま
清浄	せいじょう|しょうじょう
窃盗	せっとう
偽造	ぎぞう
拳銃	けんじゅう
謙虚	けんきょ
均衡	きんこう
履行	りこう
貨幣	かへい
透析	とうせき
旺盛	おうせい
朝廷	ちょうてい
捜し	さがし
出汁	だし
拷問	ごうもん
定款	ていかん
渋い	しぶい|しびい
償還	しょうかん
潰す	つぶす|つやす
逝く	いく|ゆく
果汁	かじゅう
粉砕	ふんさい
堆肥	たいひ|つみごえ
閉塞	へいそく
凄まじい	すさまじい
棚田	たなだ
吟味	ぎんみ
還暦	かんれき
索引	さくいん
捕虜	ほりょ
偽り	いつわり
陥る	おちいる
片岡	かたおか
語彙	ごい
統括	とうかつ
傘下	さんか
仙人	せんにん
変貌	へんぼう
痩せる	やせる
亜鉛	あえん
結核	けっかく
癒す	いやす
斬る	きる|ぎる
賭博	とばく
釣る	つる
累計	るいけい
危惧	きぐ
堆積	たいせき
要塞	ようさい
醜い	みにくい|みにきい
拭き	ふき
発泡	はっぽう
偵察	ていさつ
和尚	おしょう|かしょう|わじょう
翻弄	ほんろう
適宜	てきぎ
核心	かくしん
自粛	じしゅく
泡盛	あわもり
物凄い	ものすごい
宛て	あて
充填	じゅうてん
蜂蜜	はちみつ
今宵	こよい
呉服	ごふく
撤廃	てっぱい
由緒	ゆいしょ
還付	かんぷ
脊髄	せきずい
好き嫌い	すききらい
罵倒	ばとう
桟橋	さんばし
傲慢	ごうまん
釣具	つりぐ
失踪	しっそう
軍艦	ぐんかん
隠蔽	いんぺい
宮廷	きゅうてい
邸宅	ていたく
献血	けんけつ
旋律	せんりつ
歯磨き	はみがき
弊害	へいがい
伯爵	はくしゃく
振袖	ふりそで
勃起	ぼっき
年頃	としごろ
系譜	けいふ
諦める	あきらめる
飢え	うえ|かつえ
撤収	てっしゅう
褐色	かっしょく|かちいろ
梗塞	こうそく
租税	そぜい
竜馬	りゅうめ
唾液	だえき
壮絶	そうぜつ
浄土	じょうど
嫌う	きらう|きろう
緒方	しょほう
崇拝	すうはい
秀逸	しゅういつ
海藻	かいそう
駆逐	くちく
派閥	はばつ
競艇	きょうてい
瑠璃	るり
盆栽	ぼんさい
官邸	かんてい
嫌気	いやけ|いやき|けんき
垣間見	かいまみ
乞食	こじき|こつじき
勃発	ぼっぱつ
痕跡	こんせき
緻密	ちみつ
勲章	くんしょう
親睦	しんぼく
挿絵	さしえ
艦長	かんちょう
寄附	きふ
半袖	はんそで
抹消	まっしょう
風呂敷	ふろしき|ぶろしき
献上	けんじょう
叔母	おば|しゅくぼ
富裕	ふゆう
堀川	ほりかわ
旋回	せんかい
剥離	はくり
威嚇	いかく
脇役	わきやく
真偽	しんぎ
麻布	あさぬの|まふ
特捜	とくそう
鳥肌	とりはだ
忍耐	にんたい
紙幣	しへい
酪農	らくのう
爆睡	ばくすい
撲滅	ぼくめつ
無駄遣い	むだづかい
鍛冶	たんや|かじ
空洞	くうどう
満塁	まんるい
頑丈	がんじょう
約款	やっかん
媒介	ばいかい
括弧	かっこ
偽善	ぎぜん
避妊	ひにん
偽物	ぎぶつ|にせもの
侮辱	ぶじょく
長袖	ながそで|ちょうしゅう
代償	だいしょう
滑稽	こっけい
感銘	かんめい
干潟	ひがた
柳川	やながわ
串焼き	くしやき
糾弾	きゅうだん
挿し	さし|ざし
蛇口	じゃぐち|へびくち
廃業	はいぎょう
明瞭	めいりょう
癒着	ゆちゃく
音痴	おんち
硫酸	りゅうさん
逸脱	いつだつ
亀裂	きれつ
荒廃	こうはい
肌触り	はだざわり
書斎	しょさい
竜王	りゅうおう
宛名	あてな
煩悩	ぼんのう
男爵	だんしゃく
入江	いりえ
鉢植え	はちうえ
氾濫	はんらん
ポン酢	ぽんず
筒井	つつい
軟骨	なんこつ
参詣	さんけい
硝子	がらす|しょうし
寛容	かんよう
哀愁	あいしゅう
遺憾	いかん
享受	きょうじゅ
生還	せいかん
湧く	わく
長靴	ながぐつ|ちょうか
偏り	かたより
清涼	せいりょう
漆黒	しっこく
軍曹	ぐんそう
亭主	ていしゅ
沙汰	さた|ざた
眉毛	まゆげ
貝塚	かいづか
少佐	しょうさ
剰余	じょうよ
憧れる	あこがれる
来賓	らいひん
逸話	いつわ
頒布	はんぷ
履く	はく
裕福	ゆうふく
進呈	しんてい
美貌	びぼう
拙者	せっしゃ
擬似	ぎじ
囚われ	とらわれ
訃報	ふほう
抹殺	まっさつ
漆器	しっき
素肌	すはだ
凹凸	おうとつ
悪臭	あくしゅう
休診	きゅうしん
管弦楽	かんげんがく
麺類	めんるい
梨花	りか
大尉	たいい
誓う	ちかう|ちこう
嫌味	いやみ
ヵ所	かしょ
忍び	しのび
金剛	こんごう
鍵盤	けんばん
銃撃	じゅうげき
譜面	ふめん
潰れる	つぶれる
融通	ゆうずう|ゆずう
狙撃	そげき
年俸	ねんぽう
堕落	だらく
累積	るいせき
挟む	はさむ
払拭	ふっしょく
財閥	ざいばつ
露呈	ろてい
ヶ国	かこく
臆病	おくびょう
窮屈	きゅうくつ
有償	ゆうしょう
垣根	かきね
陥落	かんらく
囚人	しゅうじん
貝殻	かいがら
大雑把	おおざっぱ
廃絶	はいぜつ
煎餅	せんべい
修羅	しゅら
頻発	ひんぱつ
献身	けんしん
汚泥	おでい
充当	じゅうとう
漸く	ようやく
三塁	さんるい
潰瘍	かいよう
廃人	はいじん
寛ぎ	くつろぎ
下肢	かし
剛性	ごうせい
萎縮	いしゅく
塾長	じゅくちょう
全貌	ぜんぼう
裾野	すその
水仙	すいせん|ずいせん
熟睡	じゅくすい|うまい
駐屯	ちゅうとん
神棚	かみだな
蹴る	ける
数珠	じゅず|ずず
余剰	よじょう
肌寒い	はだざむい|はださむい|はだざみい|はださみい
扶助	ふじょ
偏向	へんこう
銃弾	じゅうだん
円筒	えんとう
草履	ぞうり
洞察	どうさつ
便宜	べんぎ
奔走	ほんそう
患部	かんぶ
寧ろ	むしろ
宜しい	よろしい
盗塁	とうるい
溶融	ようゆう
眉間	みけん
遷移	せんい
血栓	けっせん
肌荒れ	はだあれ
王妃	おうひ
顕彰	けんしょう
大蛇	だいじゃ|おろち
謄本	とうほん
歯茎	しけい|はぐき
気泡	きほう
尚更	なおさら
伯父	おじ|はくふ
平衡	へいこう
荘厳	しょうごん|そうごん
新譜	しんぷ
整頓	せいとん
一塁	いちるい
安泰	あんたい
痩身	そうしん
体臭	たいしゅう
憤り	いきどおり
采配	さいはい
奪還	だっかん
花瓶	かびん
納涼	のうりょう
煎茶	せんちゃ
珠玉	しゅぎょく
充てる	あてる
閑散	かんさん
挟み	はさみ|ばさみ
直轄	ちょっかつ
偽者	にせもの
友禅	ゆうぜん
盲目	もうもく|めくら
覇権	はけん
充足	じゅうそく
恐喝	きょうかつ
軽蔑	けいべつ
野良猫	のらねこ
狙える	ねらえる
塩尻	しおじり
総督	そうとく
賜物	たまもの
硫化	りゅうか
出塁	しゅつるい
比喩	ひゆ
風貌	ふうぼう
打診	だしん
儒教	じゅきょう
羅列	られつ
平岡	ひらおか
剥奪	はくだつ
禅師	ぜんじ
小鉢	こばち
挑み	いどみ
宛先	あてさき
充満	じゅうまん
軟弱	なんじゃく
遷都	せんと
早慶	そうけい
旋風	せんぷう|つむじかぜ
疎通	そつう
飢餓	きが
銘菓	めいか
恣意	しい
摩耗	まもう
懐中	かいちゅう|ふところ
睡魔	すいま
風鈴	ふうりん
中尉	ちゅうい
疲弊	ひへい
叱り	しかり
破砕	はさい
書棚	しょだな
枯渇	こかつ
覇者	はしゃ
乞う	こう
拭く	ふく
擬人	ぎじん
雪渓	せっけい
空き缶	あきかん
艦船	かんせん
青柳	あおやぎ|あおやなぎ
重曹	じゅうそう
錦糸	きんし
窮地	きゅうち
初診	しょしん
脊椎	せきつい
悠久	ゆうきゅう
塩漬け	しおづけ
雑巾	ぞうきん
巾着	きんちゃく|ぎんちゃく
払い戻し	はらいもどし
残骸	ざんがい
泥沼	どろぬま
招き猫	まねきねこ
弦楽	げんがく
二塁	にるい
逝去	せいきょ
捻挫	ねんざ
死骸	しがい
誓約	せいやく
軟式	なんしき
画伯	がはく
督促	とくそく
竜巻	たつまき
貪欲	とんよく|どんよく
醸成	じょうせい
四肢	しし
出稼ぎ	でかせぎ
宰相	さいしょう
長蛇	ちょうだ
晩酌	ばんしゃく
もの凄い	ものすごい
塾生	じゅくせい
呪縛	じゅばく
据え置き	すえおき
駄文	だぶん
懇願	こんがん
凸凹	でこぼこ
凹み	へこみ
産廃	さんぱい
蛇足	だそく
賭ける	かける|がける
沸く	わく
冷酷	れいこく
乳腺	にゅうせん
喝采	かっさい
嘲笑	ちょうしょう
縄張り	なわばり
甲羅	こうら
酢酸	さくさん
割り箸	わりばし
困窮	こんきゅう
紡ぎ	つむぎ
批准	ひじゅん
地殻	ちかく
断崖	だんがい
嗅覚	きゅうかく
中頃	なかごろ
検疫	けんえき
拙い	つたない|まじい|まずい
溶媒	ようばい
問診	もんしん
呪術	じゅじゅつ
少尉	しょうい
萎える	なえる|しなえる
遡る	さかのぼる
苛立ち	いらだち
奔放	ほんぽう
懐疑	かいぎ
疫学	えきがく
水筒	すいとう
懸け	かけ|がけ
素麺	そうめん
疫病	えきびょう|やくびょう
肢体	したい
鬱陶しい	うっとうしい
戻れる	もどれる
頑張れる	がんばれる
戦慄	せんりつ
逆戻り	ぎゃくもどり
顕在	けんざい
銘酒	めいしゅ
思索	しさく
豚汁	とんじる|ぶたじる
廃校	はいこう
疎い	うとい
酷使	こくし
湧き水	わきみず
硝酸	しょうさん
玉砕	ぎょくさい
酢の物	すのもの
召還	しょうかん
提督	ていとく
日傘	ひがさ
疎開	そかい
奈落	ならく
急須	きゅうす
肌着	はだぎ
憤慨	ふんがい
公爵	こうしゃく
寛大	かんだい
褒める	ほめる
甚大	じんだい
打撲	だぼく
甲殻	こうかく
哺乳	ほにゅう
元帥	げんすい
詐称	さしょう
二股	ふたまた
診査	しんさ
鉄拳	てっけん
艦艇	かんてい
象牙	ぞうげ
枕元	まくらもと
捻出	ねんしゅつ
懸案	けんあん
甚だ	はなはだ
蚊帳	かや|がや
餌食	えじき
稚拙	ちせつ
脱臭	だっしゅう
弁償	べんしょう
遮る	さえぎる
非核	ひかく
斑点	はんてん
家督	かとく
所轄	しょかつ
駄作	ださく
崇高	すうこう
勇壮	ゆうそう
厄除け	やくよけ
謹慎	きんしん
括り	くくり
拒ん	こばん|ことわん
護摩	ごま
郷愁	きょうしゅう
法曹	ほうそう
叱る	しかる
座禅	ざぜん
窯元	かまもと
筋腫	きんしゅ
泥酔	でいすい
補填	ほてん
塩釜	しおがま
唄う	うたう|うとう
拒む	こばむ
泡立て	あわたて|あわだて
鬱病	うつびょう
崖っぷち	がけっぷち
妖艶	ようえん
脱臼	だっきゅう
怨念	おんねん
斉唱	せいしょう
紡ぐ	つむぐ
中佐	ちゅうさ
統廃合	とうはいごう
覇王	はおう
廃盤	はいばん
咽頭	いんとう
巣窟	そうくつ
苛め	いじめ|さいなめ
罵声	ばせい
伯母	おば|はくぼ
釣り船	つりぶね
酷似	こくじ
怠惰	たいだ
滅菌	めっきん
腰椎	ようつい
杉原	すぎはら|すぎわら
送還	そうかん
湧出	わきで|ゆうしゅつ
急騰	きゅうとう
沙羅	さら|しゃら
怨霊	おんりょう
球菌	きゅうきん
見附	みつけ
捕捉	ほそく
滋養	じよう
釜飯	かまめし
捜す	さがす
煮汁	にじる
剥き出し	むきだし
呈する	ていする
側溝	そっこう
臭気	しゅうき
肉汁	にくじゅう
遮光	しゃこう
上棟	じょうとう
培地	ばいち
懲罰	ちょうばつ
賄賂	わいろ
茶漬け	ちゃづけ
雑菌	ざっきん
頭巾	ずきん|ときん
宣誓	せんせい
鹿角	ろっかく
浮腫	ふしゅ
強壮	きょうそう
留袖	とめそで
磨耗	まもう
渇き	かわき
霜降り	しもふり
酷評	こくひょう
肌色	はだいろ
下僕	げぼく
妖魔	ようま
煩雑	はんざつ
拳法	けんぽう
石臼	いしうす
化粧品	けしょうひん
廃棄物	はいきぶつ
選択肢	せんたくし
韓国人	かんこくじん
診療所	しんりょうじょ
徹底的	てっていてき
症候群	しょうこうぐん
感染症	かんせんしょう
偏差値	へんさち
花粉症	かふんしょう
洗濯機	せんたくき
学習塾	がくしゅうじゅく
履歴書	りれきしょ
認知症	にんちしょう
日韓	にっかん
披露宴	ひろうえん
釣行	ちょうこう
購入者	こうにゅうしゃ
健診	けんしん
懇親会	こんしんかい
懇談会	こんだんかい
核兵器	かくへいき
韓国語	かんこくご
消臭	しょうしゅう
子猫	こねこ
実践的	じっせんてき
牛丼	ぎゅうどん
洗濯物	せんたくもの
奨学金	しょうがくきん
不祥事	ふしょうじ
潜水艦	せんすいかん
不愉快	ふゆかい
妊娠中	にんしんちゅう
韓流	かんりゅう
顕微鏡	けんびきょう
化粧水	けしょうすい
前立腺	ぜんりつせん
循環器	じゅんかんき
熱中症	ねっちゅうしょう
自閉症	じへいしょう
不機嫌	ふきげん
依存症	いぞんしょう
後遺症	こういしょう
黒猫	くろねこ
本塁打	ほんるいだ
柔軟性	じゅうなんせい
名探偵	めいたんてい
免疫力	めんえきりょく
蛍光灯	けいこうとう
甲状腺	こうじょうせん
湧水	ゆうすい
風呂場	ふろば
大吟醸	だいぎんじょう
股関節	こかんせつ
普遍的	ふへんてき
植栽	しょくさい
駄菓子	だがし
脳梗塞	のうこうそく
不妊症	ふにんしょう
合併症	がっぺいしょう
乳酸菌	にゅうさんきん
詐欺師	さぎし
除菌	じょきん
処方箋	しょほうせん
恐怖症	きょうふしょう
消耗品	しょうもうひん
准教授	じゅんきょうじゅ
哺乳類	ほにゅうるい
診療科	しんりょうか
青汁	あおじる
関節症	かんせつしょう
核実験	かくじっけん
黒酢	くろず
浄化槽	じょうかそう
犬猫	いぬねこ
包括的	ほうかつてき
多汗症	たかんしょう
廃線	はいせん
診断書	しんだんしょ
顎関節	がくかんせつ
悪循環	あくじゅんかん
剰余金	じょうよきん
冷麺	れいめん
両脇	りょうわき
修羅場	しゅらば
妥当性	だとうせい
麻呂	まろ
製麺	せいめん
挑戦者	ちょうせんしゃ
土鍋	どなべ
薬膳	やくぜん
神経症	しんけいしょう
不謹慎	ふきんしん
虹色	にじいろ
爽快感	そうかいかん
盲導犬	もうどうけん
椎間板	ついかんばん
充実感	じゅうじつかん
枠内	わくない
治癒力	ちゆりょく
禅寺	ぜんでら
診断士	しんだんし
子守唄	こもりうた
灯籠	とうろう|どうろう
太極拳	たいきょくけん
稽古場	けいこじょう
肖像権	しょうぞうけん
肖像画	しょうぞうが
死刑囚	しけいしゅう
中韓	ちゅうかん
浄水器	じょうすいき
捜査官	そうさかん
肯定的	こうていてき
擬人化	ぎじんか
吟醸酒	ぎんじょうしゅ
不眠症	ふみんしょう
充電器	じゅうでんき
賠償金	ばいしょうきん
鍋料理	なべりょうり
駆逐艦	くちくかん
加齢臭	かれいしゅう
睡眠薬	すいみんやく
麻婆	まーぼー
核燃料	かくねんりょう
機関銃	きかんじゅう
天丼	てんどん
大腸菌	だいちょうきん
恣意的	しいてき
駐屯地	ちゅうとんち
沖縄戦	おきなわせん
清浄機	せいじょうき
診察室	しんさつしつ
訴訟法	そしょうほう
倫理的	りんりてき
発泡酒	はっぽうしゅ
産駒	さんく
弦楽器	げんがっき
亜熱帯	あねったい
麻酔科	ますいか
探偵団	たんていだん
土塁	どるい
無償化	むしょうか
偏光	へんこう
羞恥心	しゅうちしん
若旦那	わかだんな
鍛冶屋	かじや
頭蓋骨	ずがいこつ
狭心症	きょうしんしょう
不明瞭	ふめいりょう
循環器科	じゅんかんきか
愛猫	あいびょう
覚醒剤	かくせいざい
二塁打	にるいだ
昼頃	ひるごろ
腎不全	じんふぜん
亜種	あしゅ
核融合	かくゆうごう
患者数	かんじゃすう
核武装	かくぶそう
表彰台	ひょうしょうだい
親子丼	おやこどん
呉服店	ごふくてん
浄水場	じょうすいじょう
型枠	かたわく
一遍	いっぺん
韓日	かんにち